no,no_bam,situs,poktan,desa,bast,total,tanggal,ongkir
1,459,https://mpo.psp.pertanian.go.id/v.5.1/pelaporan/104752/empty,Rulih Adi Mejingkat II,Lau Garut,7375000,8275000,07-11-2023,900000
2,460,https://mpo.psp.pertanian.go.id/v.5.1/pelaporan/104754/empty,Rulih Adi Mejingkat I,Lau Garut,7375000,8275000,07-11-2023,900000
3,461,https://mpo.psp.pertanian.go.id/v.5.1/pelaporan/104756/empty,Juma Delleng,Lau Garut,7375000,8275000,07-11-2023,900000
4,462,https://mpo.psp.pertanian.go.id/v.5.1/pelaporan/104758/empty,Lagasima I,Lau Garut,7375000,8275000,07-11-2023,900000
6,464,https://mpo.psp.pertanian.go.id/v.5.1/pelaporan/104762/empty,Maju Bersama,Lau Garut,7375000,8275000,07-11-2023,900000
7,465,https://mpo.psp.pertanian.go.id/v.5.1/pelaporan/104764/empty,Mekar Jaya,Lau Garut,7080000,7944000,07-11-2023,864000
9,467,https://mpo.psp.pertanian.go.id/v.5.1/pelaporan/104768/empty,Dostahi,Lau Garut,7670000,8606000,07-11-2023,936000
10,468,https://mpo.psp.pertanian.go.id/v.5.1/pelaporan/104771/empty,Bersaudara,Lau Garut,7375000,8275000,07-11-2023,900000
11,469,https://mpo.psp.pertanian.go.id/v.5.1/pelaporan/104773/empty,Jati Putih,Lau Garut,7375000,8275000,07-11-2023,900000
12,470,https://mpo.psp.pertanian.go.id/v.5.1/pelaporan/104775/empty,Jati Putih II,Lau Garut,7375000,8275000,07-11-2023,900000
13,471,https://mpo.psp.pertanian.go.id/v.5.1/pelaporan/104777/empty,Lestari,Lau Garut,8260000,9268000,07-11-2023,1008000
14,472,https://mpo.psp.pertanian.go.id/v.5.1/pelaporan/104779/empty,Sangap Encari,Tanjung Pamah,9440000,10592000,07-11-2023,1152000
15,473,https://mpo.psp.pertanian.go.id/v.5.1/pelaporan/104780/empty,Jumpa Rejeki,Tanjung Pamah,10030000,11254000,07-11-2023,1224000
16,474,https://mpo.psp.pertanian.go.id/v.5.1/pelaporan/104783/empty,Karya Tani,Tanjung Pamah,10325000,11585000,07-11-2023,1260000
17,475,https://mpo.psp.pertanian.go.id/v.5.1/pelaporan/104785/empty,Setia Tani,Tanjung Pamah,10620000,11916000,07-11-2023,1296000
18,476,https://mpo.psp.pertanian.go.id/v.5.1/pelaporan/104787/empty,Wanita Arih Ersada,Tanjung Pamah,10030000,11254000,07-11-2023,1224000
19,477,https://mpo.psp.pertanian.go.id/v.5.1/pelaporan/104789/empty,Tunas Baru,Tanjung Pamah,9440000,10592000,07-11-2023,1152000
20,478,https://mpo.psp.pertanian.go.id/v.5.1/pelaporan/104791/empty,Ola Kisat,Tanjung Pamah,10030000,11254000,07-11-2023,1224000
21,479,https://mpo.psp.pertanian.go.id/v.5.1/pelaporan/104793/empty,Mbuah Page,Tanjung Pamah,11800000,13240000,07-11-2023,1440000
22,480,https://mpo.psp.pertanian.go.id/v.5.1/pelaporan/104795/empty,Persadanta,Tanjung Pamah,12980000,14564000,07-11-2023,1584000
23,481,https://mpo.psp.pertanian.go.id/v.5.1/pelaporan/104797/empty,Abadi,Tanjung Pamah,12390000,13902000,07-11-2023,1512000
24,482,https://mpo.psp.pertanian.go.id/v.5.1/pelaporan/104799/empty,Makmur Tani,Bukit Makmur,10030000,11254000,07-11-2023,1224000
25,483,https://mpo.psp.pertanian.go.id/v.5.1/pelaporan/104801/empty,Ersada,Bukit Makmur,10030000,11254000,07-11-2023,1224000
26,484,https://mpo.psp.pertanian.go.id/v.5.1/pelaporan/104803/empty,Juma Uruk,Bukit Makmur,9145000,10261000,07-11-2023,1116000
27,485,https://mpo.psp.pertanian.go.id/v.5.1/pelaporan/104805/empty,Mekar Mulana,Bukit Makmur,9440000,10592000,07-11-2023,1152000
28,486,https://mpo.psp.pertanian.go.id/v.5.1/pelaporan/104807/empty,Mitra,Bukit Makmur,10030000,11254000,07-11-2023,1224000
29,487,https://mpo.psp.pertanian.go.id/v.5.1/pelaporan/104809/empty,Ulih Latih,Bukit Makmur,10030000,11254000,07-11-2023,1224000
30,488,https://mpo.psp.pertanian.go.id/v.5.1/pelaporan/104811/empty,Penampat,Bukit Makmur,9735000,10923000,07-11-2023,1188000
32,490,https://mpo.psp.pertanian.go.id/v.5.1/pelaporan/104815/empty,Sangapta Ras,Lau Pengulu,7375000,8275000,07-11-2023,900000
33,491,https://mpo.psp.pertanian.go.id/v.5.1/pelaporan/104817/empty,Sabah Lama II,Lau Pengulu,8850000,9930000,07-11-2023,1080000
34,492,https://mpo.psp.pertanian.go.id/v.5.1/pelaporan/104819/empty,Tobaka,Lau Pengulu,7670000,8606000,07-11-2023,936000
35,493,https://mpo.psp.pertanian.go.id/v.5.1/pelaporan/104823/empty,Sepakat Jaya,Lau Pengulu,7670000,8606000,07-11-2023,936000
36,494,https://mpo.psp.pertanian.go.id/v.5.1/pelaporan/104824/empty,Sue Arihta,Lau Pengulu,8850000,9930000,07-11-2023,1080000
37,495,https://mpo.psp.pertanian.go.id/v.5.1/pelaporan/104827/empty,Simulih Karaben,Lau Pengulu,10325000,11585000,07-11-2023,1260000
38,496,https://mpo.psp.pertanian.go.id/v.5.1/pelaporan/104829/empty,Sabah Lama I,Lau Pengulu,8850000,9930000,07-11-2023,1080000
39,497,https://mpo.psp.pertanian.go.id/v.5.1/pelaporan/104831/empty,Nurul Iman,Lau Pengulu,9440000,10592000,07-11-2023,1152000
40,498,https://mpo.psp.pertanian.go.id/v.5.1/pelaporan/104833/empty,Arih Ersada,Lau Pengulu,8850000,9930000,07-11-2023,1080000
41,499,https://mpo.psp.pertanian.go.id/v.5.1/pelaporan/104835/empty,Muah Page,Lau Pengulu,7375000,8275000,07-11-2023,900000
42,500,https://mpo.psp.pertanian.go.id/v.5.1/pelaporan/104837/empty,Harapan Jaya,Bandar Purba,7375000,8275000,07-11-2023,900000
43,501,https://mpo.psp.pertanian.go.id/v.5.1/pelaporan/104839/empty,Gabe Naniula,Bandar Purba,8850000,9930000,07-11-2023,1080000
44,502,https://mpo.psp.pertanian.go.id/v.5.1/pelaporan/104841/empty,Dalinta Rukur,Bandar Purba,9440000,10592000,07-11-2023,1152000
45,503,https://mpo.psp.pertanian.go.id/v.5.1/pelaporan/104843/empty,Sabah Tengah,Bandar Purba,8850000,9930000,07-11-2023,1080000
46,504,https://mpo.psp.pertanian.go.id/v.5.1/pelaporan/104845/empty,Sukses Tani,Bandar Purba,10030000,11254000,07-11-2023,1224000
47,505,https://mpo.psp.pertanian.go.id/v.5.1/pelaporan/104847/empty,Usaha Bersama,Bandar Purba,8850000,9930000,07-11-2023,1080000
48,506,https://mpo.psp.pertanian.go.id/v.5.1/pelaporan/104849/empty,Jaya Tani,Bandar Purba,8850000,9930000,07-11-2023,1080000
49,507,https://mpo.psp.pertanian.go.id/v.5.1/pelaporan/104851/empty,Dostahi,Bandar Purba,10030000,11254000,07-11-2023,1224000
50,508,https://mpo.psp.pertanian.go.id/v.5.1/pelaporan/104853/empty,Bunga Jadi Buah,Bandar Purba,9440000,10592000,07-11-2023,1152000
51,509,https://mpo.psp.pertanian.go.id/v.5.1/pelaporan/104855/empty,Dosroha,Bandar Purba,10030000,11254000,07-11-2023,1224000
53,511,https://mpo.psp.pertanian.go.id/v.5.1/pelaporan/104859/empty,Sahata,Bandar Purba,10030000,11254000,07-11-2023,1224000
54,512,https://mpo.psp.pertanian.go.id/v.5.1/pelaporan/104860/empty,Tunas Muda,Bandar Purba,10030000,11254000,07-11-2023,1224000
55,513,https://mpo.psp.pertanian.go.id/v.5.1/pelaporan/104862/empty,Bandar Tani,Bandar Purba,7375000,8275000,07-11-2023,900000
56,514,https://mpo.psp.pertanian.go.id/v.5.1/pelaporan/104864/empty,Serpang Simalem,Lau Kesumpat,8850000,9930000,07-11-2023,1080000
57,515,https://mpo.psp.pertanian.go.id/v.5.1/pelaporan/104866/empty,Sawah Telko,Lau Kesumpat,7670000,8606000,07-11-2023,936000
58,516,https://mpo.psp.pertanian.go.id/v.5.1/pelaporan/104868/empty,Sativa Tani,Lau Kesumpat,8260000,9268000,07-11-2023,1008000
59,517,https://mpo.psp.pertanian.go.id/v.5.1/pelaporan/104870/empty,Lau Kasumpat,Lau Kesumpat,7080000,7944000,07-11-2023,864000
60,518,https://mpo.psp.pertanian.go.id/v.5.1/pelaporan/104872/empty,Gotong Royong,Lau Kesumpat,7375000,8275000,07-11-2023,900000
61,519,https://mpo.psp.pertanian.go.id/v.5.1/pelaporan/104874/empty,Paya Elok,Lau Kesumpat,8260000,9268000,07-11-2023,1008000
62,520,https://mpo.psp.pertanian.go.id/v.5.1/pelaporan/104876/empty,Pemarparen,Lau Kesumpat,7080000,7944000,07-11-2023,864000
63,521,https://mpo.psp.pertanian.go.id/v.5.1/pelaporan/104878/empty,Berkat Doa,Lau Kesumpat,7080000,7944000,07-11-2023,864000
64,522,https://mpo.psp.pertanian.go.id/v.5.1/pelaporan/104904/empty,Kampung Dalam Indah (Kdi),Lau Kesumpat,6490000,7282000,07-11-2023,792000
65,523,https://mpo.psp.pertanian.go.id/v.5.1/pelaporan/104905/empty,Sari Tani,Lau Kesumpat,5900000,6620000,07-11-2023,720000
66,524,https://mpo.psp.pertanian.go.id/v.5.1/pelaporan/104906/empty,Cinta Dame,Lau Kesumpat,5900000,6620000,07-11-2023,720000
67,525,https://mpo.psp.pertanian.go.id/v.5.1/pelaporan/104907/empty,Latersia,Lau Kesumpat,6490000,7282000,07-11-2023,792000
68,526,https://mpo.psp.pertanian.go.id/v.5.1/pelaporan/104908/empty,Lau Kapur,Lau Kesumpat,7080000,7944000,07-11-2023,864000
69,527,https://mpo.psp.pertanian.go.id/v.5.1/pelaporan/104909/empty,Ora Et Labora,Lau Kesumpat,7375000,8275000,07-11-2023,900000
70,528,https://mpo.psp.pertanian.go.id/v.5.1/pelaporan/104910/empty,Arih Ersada,Kuta Pengkih,11800000,13240000,07-11-2023,1440000
71,529,https://mpo.psp.pertanian.go.id/v.5.1/pelaporan/104911/empty,Bukit Simalem,Kuta Pengkih,12390000,13902000,07-11-2023,1512000
72,530,https://mpo.psp.pertanian.go.id/v.5.1/pelaporan/104912/empty,Bunga Ncole,Kuta Pengkih,13275000,14895000,07-11-2023,1620000
73,531,https://mpo.psp.pertanian.go.id/v.5.1/pelaporan/104913/empty,Bunga Mawar,Kuta Pengkih,10620000,11916000,07-11-2023,1296000
74,532,https://mpo.psp.pertanian.go.id/v.5.1/pelaporan/104914/empty,Bunga Rimna,Kuta Pengkih,11800000,13240000,07-11-2023,1440000
75,533,https://mpo.psp.pertanian.go.id/v.5.1/pelaporan/104915/empty,Bunga Ros,Kuta Pengkih,12390000,13902000,07-11-2023,1512000
76,534,https://mpo.psp.pertanian.go.id/v.5.1/pelaporan/104916/empty,Cari Kawan,Kuta Pengkih,12980000,14564000,07-11-2023,1584000
77,535,https://mpo.psp.pertanian.go.id/v.5.1/pelaporan/104917/empty,Didong Doah,Kuta Pengkih,13570000,15226000,07-11-2023,1656000
78,536,https://mpo.psp.pertanian.go.id/v.5.1/pelaporan/104918/empty,Lau Simonong,Kuta Pengkih,13275000,14895000,07-11-2023,1620000
79,537,https://mpo.psp.pertanian.go.id/v.5.1/pelaporan/104919/empty,Mbuah Page,Kuta Pengkih,13570000,15226000,07-11-2023,1656000
80,538,https://mpo.psp.pertanian.go.id/v.5.1/pelaporan/104920/empty,Sada Arih,Kuta Pengkih,12390000,13902000,07-11-2023,1512000
81,539,https://mpo.psp.pertanian.go.id/v.5.1/pelaporan/104921/empty,Persi,Kuta Pengkih,13275000,14895000,07-11-2023,1620000
82,540,https://mpo.psp.pertanian.go.id/v.5.1/pelaporan/104922/empty,Soala Gogo,Kuta Pengkih,13275000,14895000,07-11-2023,1620000
83,541,https://mpo.psp.pertanian.go.id/v.5.1/pelaporan/104923/empty,Barong Batang,Kuta Pengkih,11800000,13240000,07-11-2023,1440000
84,542,https://mpo.psp.pertanian.go.id/v.5.1/pelaporan/104924/empty,Genarasi Baru,Lau Pakam,6195000,6951000,07-11-2023,756000
85,543,https://mpo.psp.pertanian.go.id/v.5.1/pelaporan/104925/empty,Lam Uli,Lau Pakam,9145000,10261000,07-11-2023,1116000
86,544,https://mpo.psp.pertanian.go.id/v.5.1/pelaporan/104926/empty,Sawah Lama,Lau Pakam,7375000,8275000,07-11-2023,900000
87,545,https://mpo.psp.pertanian.go.id/v.5.1/pelaporan/104927/empty,Pemuda Tani,Lau Pakam,5310000,5958000,07-11-2023,648000
88,546,https://mpo.psp.pertanian.go.id/v.5.1/pelaporan/104928/empty,Gabe Subur,Lau Pakam,6195000,6951000,07-11-2023,756000
89,547,https://mpo.psp.pertanian.go.id/v.5.1/pelaporan/104929/empty,Tani Jaya,Lau Pakam,6195000,6951000,07-11-2023,756000
90,548,https://mpo.psp.pertanian.go.id/v.5.1/pelaporan/104930/empty,Anugrah,Lau Pakam,5900000,6620000,07-11-2023,720000
91,549,https://mpo.psp.pertanian.go.id/v.5.1/pelaporan/104931/empty,Cahaya,Lau Pakam,6490000,7282000,07-11-2023,792000
92,550,https://mpo.psp.pertanian.go.id/v.5.1/pelaporan/104932/empty,Cinta Maju,Lau Pakam,7080000,7944000,07-11-2023,864000
93,551,https://mpo.psp.pertanian.go.id/v.5.1/pelaporan/104933/empty,Gali Masuk,Lau Pakam,5310000,5958000,07-11-2023,648000
94,552,https://mpo.psp.pertanian.go.id/v.5.1/pelaporan/104934/empty,Tani Pusaka,Lau Pakam,6195000,6951000,07-11-2023,756000
95,553,https://mpo.psp.pertanian.go.id/v.5.1/pelaporan/104935/empty,Supra Tani,Lau Pakam,8850000,9930000,07-11-2023,1080000
96,554,https://mpo.psp.pertanian.go.id/v.5.1/pelaporan/104936/empty,Kuta Nari,Lau Pakam,5900000,6620000,07-11-2023,720000
97,555,https://mpo.psp.pertanian.go.id/v.5.1/pelaporan/104937/empty,Lam Ulina,Lau Pakam,5310000,5958000,07-11-2023,648000
98,556,https://mpo.psp.pertanian.go.id/v.5.1/pelaporan/104938/empty,Maju,Lau Pakam,5900000,6620000,07-11-2023,720000
99,557,https://mpo.psp.pertanian.go.id/v.5.1/pelaporan/104939/empty,Jaya,Lau Pakam,6785000,7613000,07-11-2023,828000
100,558,https://mpo.psp.pertanian.go.id/v.5.1/pelaporan/104940/empty,Intensif,Lau Pakam,6785000,7613000,07-11-2023,828000
101,559,https://mpo.psp.pertanian.go.id/v.5.1/pelaporan/104941/empty,Janji Matogu,Lau Pakam,7965000,8937000,07-11-2023,972000
102,560,https://mpo.psp.pertanian.go.id/v.5.1/pelaporan/104942/empty,Arih Ersada,Lau Pakam,7080000,7944000,07-11-2023,864000
103,561,https://mpo.psp.pertanian.go.id/v.5.1/pelaporan/104943/empty,Suara Tani,Lau Pakam,8555000,9599000,07-11-2023,1044000
104,562,https://mpo.psp.pertanian.go.id/v.5.1/pelaporan/104944/empty,Subur Tani,Lau Pakam,7375000,8275000,07-11-2023,900000
105,563,https://mpo.psp.pertanian.go.id/v.5.1/pelaporan/104945/empty,Sisampat-Sampaten,Lau Pakam,7375000,8275000,07-11-2023,900000
107,565,https://mpo.psp.pertanian.go.id/v.5.1/pelaporan/104947/empty,Ola Kisat,Lau Pakam,6490000,7282000,07-11-2023,792000
108,566,https://mpo.psp.pertanian.go.id/v.5.1/pelaporan/104948/empty,Maju Tani,Lau Pakam,7965000,8937000,07-11-2023,972000
109,567,https://mpo.psp.pertanian.go.id/v.5.1/pelaporan/104949/empty,Dosniroha,Lau Pakam,6490000,7282000,07-11-2023,792000
110,568,https://mpo.psp.pertanian.go.id/v.5.1/pelaporan/104950/empty,Baluren Bagas,Lau Pakam,6490000,7282000,07-11-2023,792000
113,571,https://mpo.psp.pertanian.go.id/v.5.1/pelaporan/104953/empty,Putra Tani,Lau Pakam,7670000,8606000,07-11-2023,936000
114,572,https://mpo.psp.pertanian.go.id/v.5.1/pelaporan/104954/empty,Pasar Tonga,Lau Pakam,5900000,6620000,07-11-2023,720000
115,573,https://mpo.psp.pertanian.go.id/v.5.1/pelaporan/104955/empty,Mandiri,Mardingding,7080000,7944000,07-11-2023,864000
116,574,https://mpo.psp.pertanian.go.id/v.5.1/pelaporan/104956/empty,Simulih Karaben,Mardingding,6195000,6951000,07-11-2023,756000
117,575,https://mpo.psp.pertanian.go.id/v.5.1/pelaporan/104957/empty,Silegin Ukur,Mardingding,5605000,6289000,07-11-2023,684000
118,576,https://mpo.psp.pertanian.go.id/v.5.1/pelaporan/104958/empty,Kelengna,Mardingding,5900000,6620000,07-11-2023,720000
119,577,https://mpo.psp.pertanian.go.id/v.5.1/pelaporan/104959/empty,Cinta Ibu,Mardingding,6195000,6951000,07-11-2023,756000
120,578,https://mpo.psp.pertanian.go.id/v.5.1/pelaporan/104960/empty,Sada Arih,Mardingding,5605000,6289000,07-11-2023,684000
121,579,https://mpo.psp.pertanian.go.id/v.5.1/pelaporan/104961/empty,Swakarya,Mardingding,7080000,7944000,07-11-2023,864000
122,580,https://mpo.psp.pertanian.go.id/v.5.1/pelaporan/104962/empty,Serba Guna,Mardingding,6195000,6951000,07-11-2023,756000
123,581,https://mpo.psp.pertanian.go.id/v.5.1/pelaporan/104963/empty,Kekelengenta Ras,Mardingding,5605000,6289000,07-11-2023,684000
124,582,https://mpo.psp.pertanian.go.id/v.5.1/pelaporan/104964/empty,Tunas Muda,Mardingding,5605000,6289000,07-11-2023,684000
125,583,https://mpo.psp.pertanian.go.id/v.5.1/pelaporan/104965/empty,Mamre B,Mardingding,5015000,5627000,07-11-2023,612000
126,584,https://mpo.psp.pertanian.go.id/v.5.1/pelaporan/104966/empty,Mangga Dua,Mardingding,5310000,5958000,07-11-2023,648000
127,585,https://mpo.psp.pertanian.go.id/v.5.1/pelaporan/104967/empty,Tambar Malem A,Mardingding,6490000,7282000,07-11-2023,792000
128,586,https://mpo.psp.pertanian.go.id/v.5.1/pelaporan/104968/empty,KBG RK,Mardingding,7670000,8606000,07-11-2023,936000
129,587,https://mpo.psp.pertanian.go.id/v.5.1/pelaporan/104969/empty,Karoni,Mardingding,6490000,7282000,07-11-2023,792000
130,588,https://mpo.psp.pertanian.go.id/v.5.1/pelaporan/104970/empty,Sejahtera,Mardingding,5900000,6620000,07-11-2023,720000
131,589,https://mpo.psp.pertanian.go.id/v.5.1/pelaporan/104971/empty,Tambar Malem B,Mardingding,5900000,6620000,07-11-2023,720000
132,590,https://mpo.psp.pertanian.go.id/v.5.1/pelaporan/104972/empty,Paya Kelambue,Mardingding,5015000,5627000,07-11-2023,612000
133,591,https://mpo.psp.pertanian.go.id/v.5.1/pelaporan/104973/empty,Soala Gogo,Mardingding,5605000,6289000,07-11-2023,684000
134,592,https://mpo.psp.pertanian.go.id/v.5.1/pelaporan/104974/empty,Panggong Budan,Mardingding,5605000,6289000,07-11-2023,684000
135,593,https://mpo.psp.pertanian.go.id/v.5.1/pelaporan/104975/empty,Lau Tualang Simalem,Mardingding,5605000,6289000,07-11-2023,684000
136,594,https://mpo.psp.pertanian.go.id/v.5.1/pelaporan/104976/empty,Ajar Bancina,Mardingding,6195000,6951000,07-11-2023,756000
137,595,https://mpo.psp.pertanian.go.id/v.5.1/pelaporan/104977/empty,Sini Suka,Mardingding,5605000,6289000,07-11-2023,684000
138,596,https://mpo.psp.pertanian.go.id/v.5.1/pelaporan/104978/empty,Batu Mamak,Mardingding,4720000,5296000,07-11-2023,576000
139,597,https://mpo.psp.pertanian.go.id/v.5.1/pelaporan/104979/empty,Suka Bersama,Mardingding,7965000,8937000,07-11-2023,972000
140,598,https://mpo.psp.pertanian.go.id/v.5.1/pelaporan/104980/empty,Sada Nioga,Mardingding,6195000,6951000,07-11-2023,756000
141,599,https://mpo.psp.pertanian.go.id/v.5.1/pelaporan/104981/empty,Kembar Jaya,Mardingding,5605000,6289000,07-11-2023,684000
142,600,https://mpo.psp.pertanian.go.id/v.5.1/pelaporan/104982/empty,Harapan Bersama,Mardingding,5605000,6289000,07-11-2023,684000
143,601,https://mpo.psp.pertanian.go.id/v.5.1/pelaporan/104983/empty,Milala Jaya,Mardingding,5900000,6620000,07-11-2023,720000
144,602,https://mpo.psp.pertanian.go.id/v.5.1/pelaporan/104984/empty,Bunga Ncole,Mardingding,5605000,6289000,07-11-2023,684000
145,603,https://mpo.psp.pertanian.go.id/v.5.1/pelaporan/104985/empty,Sibiak Keluarga,Mardingding,5900000,6620000,07-11-2023,720000
146,604,https://mpo.psp.pertanian.go.id/v.5.1/pelaporan/104986/empty,Saymara,Mardingding,7080000,7944000,07-11-2023,864000
147,605,https://mpo.psp.pertanian.go.id/v.5.1/pelaporan/104987/empty,Bunda,Mardingding,5015000,5627000,07-11-2023,612000
148,606,https://mpo.psp.pertanian.go.id/v.5.1/pelaporan/104988/empty,Sejalan,Mardingding,7080000,7944000,07-11-2023,864000
149,607,https://mpo.psp.pertanian.go.id/v.5.1/pelaporan/104989/empty,Aronta,Mardingding,5310000,5958000,07-11-2023,648000
150,608,https://mpo.psp.pertanian.go.id/v.5.1/pelaporan/104990/empty,Pakkat,Mardingding,5900000,6620000,07-11-2023,720000
151,609,https://mpo.psp.pertanian.go.id/v.5.1/pelaporan/104991/empty,Arsani,Mardingding,6195000,6951000,07-11-2023,756000
152,610,https://mpo.psp.pertanian.go.id/v.5.1/pelaporan/104992/empty,Rukun Siroga,Mardingding,5605000,6289000,07-11-2023,684000
153,611,https://mpo.psp.pertanian.go.id/v.5.1/pelaporan/104993/empty,Mamre A,Mardingding,7080000,7944000,07-11-2023,864000
154,612,https://mpo.psp.pertanian.go.id/v.5.1/pelaporan/104994/empty,Subur Tani,Mardingding,7080000,7944000,07-11-2023,864000
155,613,https://mpo.psp.pertanian.go.id/v.5.1/pelaporan/104995/empty,Page Tambar Lihe,Mardingding,5900000,6620000,07-11-2023,720000
156,614,https://mpo.psp.pertanian.go.id/v.5.1/pelaporan/104996/empty,Persadanta,Mardingding,6195000,6951000,07-11-2023,756000
157,615,https://mpo.psp.pertanian.go.id/v.5.1/pelaporan/104997/empty,Galoh Simbelang,Mardingding,5605000,6289000,07-11-2023,684000
158,616,https://mpo.psp.pertanian.go.id/v.5.1/pelaporan/104998/empty,Sisampaten,Mardingding,5605000,6289000,07-11-2023,684000
159,617,https://mpo.psp.pertanian.go.id/v.5.1/pelaporan/104999/empty,Fajar Tani,Mardingding,5900000,6620000,07-11-2023,720000
160,618,https://mpo.psp.pertanian.go.id/v.5.1/pelaporan/105000/empty,Lanogan,Mardingding,7080000,7944000,07-11-2023,864000
161,619,https://mpo.psp.pertanian.go.id/v.5.1/pelaporan/105001/empty,Karoja,Mardingding,5900000,6620000,07-11-2023,720000
162,620,https://mpo.psp.pertanian.go.id/v.5.1/pelaporan/105002/empty,Pengalahen Simalem,Mardingding,5605000,6289000,07-11-2023,684000
163,621,https://mpo.psp.pertanian.go.id/v.5.1/pelaporan/105003/empty,Hibrida I,Mardingding,5015000,5627000,07-11-2023,612000
164,622,https://mpo.psp.pertanian.go.id/v.5.1/pelaporan/105004/empty,Swakarya,Rimo Bunga,7375000,8275000,07-11-2023,900000
165,623,https://mpo.psp.pertanian.go.id/v.5.1/pelaporan/105005/empty,Maju Bersama,Rimo Bunga,7375000,8275000,07-11-2023,900000
166,624,https://mpo.psp.pertanian.go.id/v.5.1/pelaporan/105006/empty,Lit Gunana,Rimo Bunga,7375000,8275000,07-11-2023,900000
167,625,https://mpo.psp.pertanian.go.id/v.5.1/pelaporan/105007/empty,Lopiga,Rimo Bunga,7375000,8275000,07-11-2023,900000
168,626,https://mpo.psp.pertanian.go.id/v.5.1/pelaporan/105008/empty,Martabe,Batu Rongkam,10325000,11585000,07-11-2023,1260000
169,627,https://mpo.psp.pertanian.go.id/v.5.1/pelaporan/105009/empty,Dos Roha,Batu Rongkam,12980000,14564000,07-11-2023,1584000
170,628,https://mpo.psp.pertanian.go.id/v.5.1/pelaporan/105010/empty,Page Mulana,Batu Rongkam,13275000,14895000,07-11-2023,1620000
171,629,https://mpo.psp.pertanian.go.id/v.5.1/pelaporan/105011/empty,Saroha,Batu Rongkam,12980000,14564000,07-11-2023,1584000
172,630,https://mpo.psp.pertanian.go.id/v.5.1/pelaporan/105012/empty,Martabe II,Batu Rongkam,12390000,13902000,07-11-2023,1512000
173,631,https://mpo.psp.pertanian.go.id/v.5.1/pelaporan/105013/empty,Bersama Tani,Batu Rongkam,12390000,13902000,07-11-2023,1512000
174,632,https://mpo.psp.pertanian.go.id/v.5.1/pelaporan/105014/empty,Rim Ni Tahi,Batu Rongkam,11800000,13240000,07-11-2023,1440000
175,633,https://mpo.psp.pertanian.go.id/v.5.1/pelaporan/105015/empty,Pemuda Pancasila,Buluh Pancur,8850000,9930000,07-11-2023,1080000
176,634,https://mpo.psp.pertanian.go.id/v.5.1/pelaporan/105016/empty,Erlajar Robah,Buluh Pancur,10325000,11585000,07-11-2023,1260000
177,635,https://mpo.psp.pertanian.go.id/v.5.1/pelaporan/105017/empty,Mula Ni Holong,Buluh Pancur,11800000,13240000,07-11-2023,1440000
178,636,https://mpo.psp.pertanian.go.id/v.5.1/pelaporan/105018/empty,Genting Buara I,Buluh Pancur,12390000,13902000,07-11-2023,1512000
179,637,https://mpo.psp.pertanian.go.id/v.5.1/pelaporan/105019/empty,Wanita Tani,Buluh Pancur,11210000,12578000,07-11-2023,1368000
180,638,https://mpo.psp.pertanian.go.id/v.5.1/pelaporan/105020/empty,Sepadan,Buluh Pancur,11800000,13240000,07-11-2023,1440000
181,639,https://mpo.psp.pertanian.go.id/v.5.1/pelaporan/105021/empty,Mbuah Page,Buluh Pancur,10325000,11585000,07-11-2023,1260000
182,640,https://mpo.psp.pertanian.go.id/v.5.1/pelaporan/105022/empty,Sada Iyoga,Buluh Pancur,10620000,11916000,07-11-2023,1296000
183,641,https://mpo.psp.pertanian.go.id/v.5.1/pelaporan/105023/empty,Genting Buara,Buluh Pancur,11800000,13240000,07-11-2023,1440000
184,642,https://mpo.psp.pertanian.go.id/v.5.1/pelaporan/105024/empty,Sada Arih,Buluh Pancur,12390000,13902000,07-11-2023,1512000
185,643,https://mpo.psp.pertanian.go.id/v.5.1/pelaporan/105026/empty,Ketang Rontih,Buluh Pancur,10325000,11585000,07-11-2023,1260000
186,644,https://mpo.psp.pertanian.go.id/v.5.1/pelaporan/105027/empty,Jumpa Rejeki,Rambah Tampu,11800000,13240000,07-11-2023,1440000
187,645,https://mpo.psp.pertanian.go.id/v.5.1/pelaporan/105029/empty,Parik Baru Arih Ersada,Rambah Tampu,14750000,16550000,07-11-2023,1800000
188,646,https://mpo.psp.pertanian.go.id/v.5.1/pelaporan/105030/empty,Tambak Linor,Rambah Tampu,14750000,16550000,07-11-2023,1800000
189,647,https://mpo.psp.pertanian.go.id/v.5.1/pelaporan/105031/empty,Bunga Mawar,Rambah Tampu,15930000,17874000,07-11-2023,1944000
190,648,https://mpo.psp.pertanian.go.id/v.5.1/pelaporan/105032/empty,Lestari,Rambah Tampu,11210000,12578000,07-11-2023,1368000
191,649,https://mpo.psp.pertanian.go.id/v.5.1/pelaporan/105033/empty,Sabah Lama,Rambah Tampu,10030000,11254000,07-11-2023,1224000
192,650,https://mpo.psp.pertanian.go.id/v.5.1/pelaporan/105034/empty,Mbuah Page,Rambah Tampu,10620000,11916000,07-11-2023,1296000
193,651,https://mpo.psp.pertanian.go.id/v.5.1/pelaporan/105035/empty,Parik Mbelin,Rambah Tampu,7375000,8275000,07-11-2023,900000
194,652,https://mpo.psp.pertanian.go.id/v.5.1/pelaporan/105036/empty,Pioner,Rambah Tampu,10325000,11585000,07-11-2023,1260000
195,653,https://mpo.psp.pertanian.go.id/v.5.1/pelaporan/105037/empty,Mutiara,Kutambelin,10325000,11585000,07-11-2023,1260000
196,654,https://mpo.psp.pertanian.go.id/v.5.1/pelaporan/105038/empty,Rimo Manis,Kutambelin,9145000,10261000,07-11-2023,1116000
197,655,https://mpo.psp.pertanian.go.id/v.5.1/pelaporan/105039/empty,Lit Ulih Nggit,Kutambelin,9145000,10261000,07-11-2023,1116000
198,656,https://mpo.psp.pertanian.go.id/v.5.1/pelaporan/105040/empty,Mekar Tani,Kutambelin,9145000,10261000,07-11-2023,1116000
199,657,https://mpo.psp.pertanian.go.id/v.5.1/pelaporan/105041/empty,Mbelin Gunana,Kutambelin,9145000,10261000,07-11-2023,1116000
200,658,https://mpo.psp.pertanian.go.id/v.5.1/pelaporan/105042/empty,Tani jaya,Kutambelin,9145000,10261000,07-11-2023,1116000
201,659,https://mpo.psp.pertanian.go.id/v.5.1/pelaporan/105043/empty,La Megogo,Kutambelin,9145000,10261000,07-11-2023,1116000
202,660,https://mpo.psp.pertanian.go.id/v.5.1/pelaporan/105044/empty,Deleng Salit,Durin Rugun,5900000,6620000,07-11-2023,720000
203,661,https://mpo.psp.pertanian.go.id/v.5.1/pelaporan/105045/empty,Juma Lepar,Durin Rugun,5900000,6620000,07-11-2023,720000
204,662,https://mpo.psp.pertanian.go.id/v.5.1/pelaporan/105046/empty,Batu Rongring,Durin Rugun,5900000,6620000,07-11-2023,720000
205,663,https://mpo.psp.pertanian.go.id/v.5.1/pelaporan/105048/empty,Arih Ersada,Durin Rugun,5900000,6620000,07-11-2023,720000
206,664,https://mpo.psp.pertanian.go.id/v.5.1/pelaporan/105049/empty,Durin Sirulo,Durin Rugun,5900000,6620000,07-11-2023,720000
207,665,https://mpo.psp.pertanian.go.id/v.5.1/pelaporan/105050/empty,Baluren Mbagas,Lau Peradep,5900000,6620000,07-11-2023,720000
208,666,https://mpo.psp.pertanian.go.id/v.5.1/pelaporan/105051/empty,Siangkan,Lau Peradep,6490000,7282000,07-11-2023,792000
209,667,https://mpo.psp.pertanian.go.id/v.5.1/pelaporan/105052/empty,Mbera Mbuah,Lau Peradep,5900000,6620000,07-11-2023,720000
210,668,https://mpo.psp.pertanian.go.id/v.5.1/pelaporan/105054/empty,Arih Ersada,Lau Peradep,6490000,7282000,07-11-2023,792000
211,669,https://mpo.psp.pertanian.go.id/v.5.1/pelaporan/105055/empty,Tarigan Sirulo,Lau Baleng,8850000,9930000,07-11-2023,1080000
212,670,https://mpo.psp.pertanian.go.id/v.5.1/pelaporan/105056/empty,Dalinta Ras,Lau Baleng,10030000,11254000,07-11-2023,1224000
213,671,https://mpo.psp.pertanian.go.id/v.5.1/pelaporan/105057/empty,Maju Bersama,Lau Baleng,9440000,10592000,07-11-2023,1152000
214,672,https://mpo.psp.pertanian.go.id/v.5.1/pelaporan/105058/empty,Putra Petani,Lau Baleng,10030000,11254000,07-11-2023,1224000
215,673,https://mpo.psp.pertanian.go.id/v.5.1/pelaporan/105059/empty,Urok Ipoh I,Lau Baleng,10325000,11585000,07-11-2023,1260000
216,674,https://mpo.psp.pertanian.go.id/v.5.1/pelaporan/105060/empty,La Megogo,Lau Baleng,10030000,11254000,07-11-2023,1224000
217,675,https://mpo.psp.pertanian.go.id/v.5.1/pelaporan/105061/empty,Kutarih Simalem,Lau Baleng,10620000,11916000,07-11-2023,1296000
218,676,https://mpo.psp.pertanian.go.id/v.5.1/pelaporan/105062/empty,Deleng Mbelteng,Lau Baleng,10325000,11585000,07-11-2023,1260000
219,677,https://mpo.psp.pertanian.go.id/v.5.1/pelaporan/105063/empty,Lau Melas,Lau Baleng,10030000,11254000,07-11-2023,1224000
220,678,https://mpo.psp.pertanian.go.id/v.5.1/pelaporan/105064/empty,Bunga,Lau Baleng,10620000,11916000,07-11-2023,1296000
221,679,https://mpo.psp.pertanian.go.id/v.5.1/pelaporan/105065/empty,Maduma Tani,Lau Baleng,11210000,12578000,07-11-2023,1368000
222,680,https://mpo.psp.pertanian.go.id/v.5.1/pelaporan/105066/empty,Ukur Meriah,Lau Baleng,10620000,11916000,07-11-2023,1296000
223,681,https://mpo.psp.pertanian.go.id/v.5.1/pelaporan/105068/empty,Juma Tenggiring,Lau Baleng,10030000,11254000,07-11-2023,1224000
224,682,https://mpo.psp.pertanian.go.id/v.5.1/pelaporan/105069/empty,Holong Mangalop Holong,Lau Baleng,10325000,11585000,07-11-2023,1260000
225,683,https://mpo.psp.pertanian.go.id/v.5.1/pelaporan/105070/empty,Sabah Jarulo,Lau Baleng,9440000,10592000,07-11-2023,1152000
226,684,https://mpo.psp.pertanian.go.id/v.5.1/pelaporan/105071/empty,Lau Pemuluten,Lau Baleng,10030000,11254000,07-11-2023,1224000
227,685,https://mpo.psp.pertanian.go.id/v.5.1/pelaporan/105072/empty,Parbato,Lau Baleng,9735000,10923000,07-11-2023,1188000
228,686,https://mpo.psp.pertanian.go.id/v.5.1/pelaporan/105073/empty,Tunas Baru,Lau Baleng,10325000,11585000,07-11-2023,1260000
229,687,https://mpo.psp.pertanian.go.id/v.5.1/pelaporan/105074/empty,Lau Diher,Lau Baleng,7375000,8275000,07-11-2023,900000
230,688,https://mpo.psp.pertanian.go.id/v.5.1/pelaporan/105075/empty,Sepakat,Lau Baleng,10030000,11254000,07-11-2023,1224000
231,689,https://mpo.psp.pertanian.go.id/v.5.1/pelaporan/105077/empty,Horas Martani,Lau Baleng,7670000,8606000,07-11-2023,936000
232,690,https://mpo.psp.pertanian.go.id/v.5.1/pelaporan/105078/empty,Jarulo,Lau Baleng,8260000,9268000,07-11-2023,1008000
233,691,https://mpo.psp.pertanian.go.id/v.5.1/pelaporan/105079/empty,Butuh Pupuk,Lau Baleng,7965000,8937000,07-11-2023,972000
234,692,https://mpo.psp.pertanian.go.id/v.5.1/pelaporan/105080/empty,Sangap Encari,Lau Baleng,7080000,7944000,07-11-2023,864000
235,693,https://mpo.psp.pertanian.go.id/v.5.1/pelaporan/105081/empty,Sangapta Tani,Lau Baleng,7670000,8606000,07-11-2023,936000
236,694,https://mpo.psp.pertanian.go.id/v.5.1/pelaporan/105083/empty,Super ACI,Lau Baleng,10030000,11254000,07-11-2023,1224000
237,695,https://mpo.psp.pertanian.go.id/v.5.1/pelaporan/105085/empty,Maju Tani,Lau Baleng,8850000,9930000,07-11-2023,1080000
238,696,https://mpo.psp.pertanian.go.id/v.5.1/pelaporan/105086/empty,Uruk Ipoh II,Lau Baleng,7080000,7944000,07-11-2023,864000
239,697,https://mpo.psp.pertanian.go.id/v.5.1/pelaporan/105087/empty,Legio,Lau Baleng,7375000,8275000,07-11-2023,900000
240,698,https://mpo.psp.pertanian.go.id/v.5.1/pelaporan/105088/empty,Negeriku,Mbal-Mbal Petarum,7375000,8275000,07-11-2023,900000
241,699,https://mpo.psp.pertanian.go.id/v.5.1/pelaporan/105089/empty,Merih Unggul,Mbal-Mbal Petarum,7670000,8606000,07-11-2023,936000
242,700,https://mpo.psp.pertanian.go.id/v.5.1/pelaporan/105090/empty,Deleng Pola,Mbal-Mbal Petarum,7375000,8275000,07-11-2023,900000
243,701,https://mpo.psp.pertanian.go.id/v.5.1/pelaporan/105091/empty,Gurky,Mbal-Mbal Petarum,8260000,9268000,07-11-2023,1008000
244,702,https://mpo.psp.pertanian.go.id/v.5.1/pelaporan/105092/empty,Arih Ersada,Mbal-Mbal Petarum,8850000,9930000,07-11-2023,1080000
245,703,https://mpo.psp.pertanian.go.id/v.5.1/pelaporan/105093/empty,Panggong Lama I,Mbal-Mbal Petarum,9440000,10592000,07-11-2023,1152000
246,704,https://mpo.psp.pertanian.go.id/v.5.1/pelaporan/105094/empty,Solok,Mbal-Mbal Petarum,9735000,10923000,07-11-2023,1188000
247,705,https://mpo.psp.pertanian.go.id/v.5.1/pelaporan/105096/empty,Tani Mulia,Mbal-Mbal Petarum,10030000,11254000,07-11-2023,1224000
248,706,https://mpo.psp.pertanian.go.id/v.5.1/pelaporan/105100/empty,Juma PT,Mbal-Mbal Petarum,9440000,10592000,07-11-2023,1152000
249,707,https://mpo.psp.pertanian.go.id/v.5.1/pelaporan/105101/empty,Juma Tulan Gajah,Mbal-Mbal Petarum,10620000,11916000,07-11-2023,1296000
250,708,https://mpo.psp.pertanian.go.id/v.5.1/pelaporan/105102/empty,Gelonggong Simalem I,Mbal-Mbal Petarum,9440000,10592000,07-11-2023,1152000
251,709,https://mpo.psp.pertanian.go.id/v.5.1/pelaporan/105103/empty,Paya Lah-Lah,Mbal-Mbal Petarum,10620000,11916000,07-11-2023,1296000
252,710,https://mpo.psp.pertanian.go.id/v.5.1/pelaporan/105104/empty,Panggong Lama,Mbal-Mbal Petarum,11210000,12578000,07-11-2023,1368000
253,711,https://mpo.psp.pertanian.go.id/v.5.1/pelaporan/105105/empty,Sada Arih,Mbal-Mbal Petarum,10030000,11254000,07-11-2023,1224000
254,712,https://mpo.psp.pertanian.go.id/v.5.1/pelaporan/105106/empty,Paya Mbelang,Mbal-Mbal Petarum,11210000,12578000,07-11-2023,1368000
255,713,https://mpo.psp.pertanian.go.id/v.5.1/pelaporan/105107/empty,Liang Gepgep,Mbal-Mbal Petarum,10325000,11585000,07-11-2023,1260000
256,714,https://mpo.psp.pertanian.go.id/v.5.1/pelaporan/105108/empty,Liang Gajah,Kinangkong,7080000,7944000,07-11-2023,864000
257,715,https://mpo.psp.pertanian.go.id/v.5.1/pelaporan/105109/empty,Tanjong Bale,Kinangkong,8555000,9599000,07-11-2023,1044000
258,716,https://mpo.psp.pertanian.go.id/v.5.1/pelaporan/105110/empty,Ujung Pinem,Kinangkong,8555000,9599000,07-11-2023,1044000
259,717,https://mpo.psp.pertanian.go.id/v.5.1/pelaporan/105111/empty,Tunas Harapan Tani,Kinangkong,9440000,10592000,07-11-2023,1152000
260,718,https://mpo.psp.pertanian.go.id/v.5.1/pelaporan/105112/empty,Uruk Gendan,Kinangkong,10030000,11254000,07-11-2023,1224000
261,719,https://mpo.psp.pertanian.go.id/v.5.1/pelaporan/105113/empty,Lau Roga,Kinangkong,8850000,9930000,07-11-2023,1080000
262,720,https://mpo.psp.pertanian.go.id/v.5.1/pelaporan/105114/empty,Martubung,Kinangkong,7375000,8275000,07-11-2023,900000
264,722,https://mpo.psp.pertanian.go.id/v.5.1/pelaporan/105116/empty,Kujuma Kurumah,Kinangkong,7080000,7944000,07-11-2023,864000
265,723,https://mpo.psp.pertanian.go.id/v.5.1/pelaporan/105117/empty,Perjuma Tuhur,Selandi,5900000,6620000,13-11-2023,720000
267,725,https://mpo.psp.pertanian.go.id/v.5.1/pelaporan/105119/empty,Pulubalang,Selandi,5900000,6620000,13-11-2023,720000
269,727,https://mpo.psp.pertanian.go.id/v.5.1/pelaporan/105121/empty,Sabah Lau Melas,Selandi,5900000,6620000,13-11-2023,720000
270,728,https://mpo.psp.pertanian.go.id/v.5.1/pelaporan/105122/empty,Similih Karaben,Selandi,5900000,6620000,13-11-2023,720000
271,729,https://mpo.psp.pertanian.go.id/v.5.1/pelaporan/105123/empty,Juma Belan,Rimo Kayu,7375000,8275000,13-11-2023,900000
272,730,https://mpo.psp.pertanian.go.id/v.5.1/pelaporan/105124/empty,Lau Guna,Rimo Kayu,7080000,7944000,13-11-2023,864000
273,731,https://mpo.psp.pertanian.go.id/v.5.1/pelaporan/105125/empty,Kuta Male,Rimo Kayu,5900000,6620000,13-11-2023,720000
274,732,https://mpo.psp.pertanian.go.id/v.5.1/pelaporan/105126/empty,Juma Mbergang,Rimo Kayu,7080000,7944000,13-11-2023,864000
275,733,https://mpo.psp.pertanian.go.id/v.5.1/pelaporan/105127/empty,Inpres,Rimo Kayu,5900000,6620000,13-11-2023,720000
277,735,https://mpo.psp.pertanian.go.id/v.5.1/pelaporan/105130/empty,Belan,Rimo Kayu,7080000,7944000,13-11-2023,864000
278,736,https://mpo.psp.pertanian.go.id/v.5.1/pelaporan/105131/empty,Ersada Ukur,Payung,6490000,7282000,13-11-2023,792000
279,737,https://mpo.psp.pertanian.go.id/v.5.1/pelaporan/105132/empty,Lau Meciho,Payung,7080000,7944000,13-11-2023,864000
280,738,https://mpo.psp.pertanian.go.id/v.5.1/pelaporan/105133/empty,Maju Bersama,Payung,10325000,11585000,13-11-2023,1260000
282,740,https://mpo.psp.pertanian.go.id/v.5.1/pelaporan/105136/empty,Kuta Bangun,Payung,5900000,6620000,13-11-2023,720000
283,741,https://mpo.psp.pertanian.go.id/v.5.1/pelaporan/105137/empty,Tebing Pringgan,Payung,7670000,8606000,13-11-2023,936000
284,742,https://mpo.psp.pertanian.go.id/v.5.1/pelaporan/105138/empty,Juma Mbacang,Payung,7670000,8606000,13-11-2023,936000
285,743,https://mpo.psp.pertanian.go.id/v.5.1/pelaporan/105139/empty,Sangapta Ras,Payung,5900000,6620000,13-11-2023,720000
286,744,https://mpo.psp.pertanian.go.id/v.5.1/pelaporan/105140/empty,Mentari Pagi,Payung,8850000,9930000,13-11-2023,1080000
287,745,https://mpo.psp.pertanian.go.id/v.5.1/pelaporan/105141/empty,Payung Simalem,Payung,5900000,6620000,13-11-2023,720000
289,747,https://mpo.psp.pertanian.go.id/v.5.1/pelaporan/105143/empty,Mandiri,Payung,7080000,7944000,13-11-2023,864000
290,748,https://mpo.psp.pertanian.go.id/v.5.1/pelaporan/105144/empty,Ersada Arih,Payung,7965000,8937000,13-11-2023,972000
291,749,https://mpo.psp.pertanian.go.id/v.5.1/pelaporan/105145/empty,Sisampat Sampaten,Payung,7080000,7944000,13-11-2023,864000
292,750,https://mpo.psp.pertanian.go.id/v.5.1/pelaporan/105146/empty,Sumber Sepakat,Payung,5900000,6620000,13-11-2023,720000
293,751,https://mpo.psp.pertanian.go.id/v.5.1/pelaporan/105147/empty,Lau Ndehara,Payung,5900000,6620000,13-11-2023,720000
294,752,https://mpo.psp.pertanian.go.id/v.5.1/pelaporan/105148/empty,Tani Makmur,Payung,7080000,7944000,13-11-2023,864000
295,753,https://mpo.psp.pertanian.go.id/v.5.1/pelaporan/105149/empty,Karya Bersama,Payung,6490000,7282000,13-11-2023,792000
296,754,https://mpo.psp.pertanian.go.id/v.5.1/pelaporan/105150/empty,Sada Nioga,Payung,5900000,6620000,13-11-2023,720000
297,755,https://mpo.psp.pertanian.go.id/v.5.1/pelaporan/105151/empty,Buah Kitik,Batukarang,5900000,6620000,13-11-2023,720000
298,756,https://mpo.psp.pertanian.go.id/v.5.1/pelaporan/105153/empty,Lau Buluh,Batukarang,5900000,6620000,13-11-2023,720000
299,757,https://mpo.psp.pertanian.go.id/v.5.1/pelaporan/105154/empty,Gempul Area,Batukarang,5900000,6620000,13-11-2023,720000
300,758,https://mpo.psp.pertanian.go.id/v.5.1/pelaporan/105155/empty,Kepariung,Batukarang,6490000,7282000,13-11-2023,792000
301,759,https://mpo.psp.pertanian.go.id/v.5.1/pelaporan/105156/empty,Tambak Lau Bengkuang,Batukarang,5900000,6620000,13-11-2023,720000
302,760,https://mpo.psp.pertanian.go.id/v.5.1/pelaporan/105157/empty,Juma Rih Simalem,Batukarang,6490000,7282000,13-11-2023,792000
303,761,https://mpo.psp.pertanian.go.id/v.5.1/pelaporan/105158/empty,Juma Rih II,Batukarang,5900000,6620000,13-11-2023,720000
304,762,https://mpo.psp.pertanian.go.id/v.5.1/pelaporan/105159/empty,Singgahmata,Batukarang,6490000,7282000,13-11-2023,792000
305,763,https://mpo.psp.pertanian.go.id/v.5.1/pelaporan/105160/empty,Tampe Cinah,Batukarang,6490000,7282000,13-11-2023,792000
306,764,https://mpo.psp.pertanian.go.id/v.5.1/pelaporan/105161/empty,Tampe Cinah II,Batukarang,6490000,7282000,13-11-2023,792000
308,766,https://mpo.psp.pertanian.go.id/v.5.1/pelaporan/105163/empty,Lau Paya II,Batukarang,6490000,7282000,13-11-2023,792000
309,767,https://mpo.psp.pertanian.go.id/v.5.1/pelaporan/105164/empty,Lau Pinang,Batukarang,6490000,7282000,13-11-2023,792000
310,768,https://mpo.psp.pertanian.go.id/v.5.1/pelaporan/105165/empty,Tembusuh,Batukarang,6490000,7282000,13-11-2023,792000
311,769,https://mpo.psp.pertanian.go.id/v.5.1/pelaporan/105166/empty,Uruk Saribu,Batukarang,5900000,6620000,13-11-2023,720000
312,770,https://mpo.psp.pertanian.go.id/v.5.1/pelaporan/105167/empty,Tingkat-Tingkat,Batukarang,5900000,6620000,13-11-2023,720000
313,771,https://mpo.psp.pertanian.go.id/v.5.1/pelaporan/105168/empty,Dalan Kutiga,Batukarang,5900000,6620000,13-11-2023,720000
314,772,https://mpo.psp.pertanian.go.id/v.5.1/pelaporan/105169/empty,Kite Buah,Batukarang,6490000,7282000,13-11-2023,792000
315,773,https://mpo.psp.pertanian.go.id/v.5.1/pelaporan/105170/empty,Kite Buah II,Batukarang,5900000,6620000,13-11-2023,720000
316,774,https://mpo.psp.pertanian.go.id/v.5.1/pelaporan/105171/empty,Barong Mbertik,Batukarang,6490000,7282000,13-11-2023,792000
317,775,https://mpo.psp.pertanian.go.id/v.5.1/pelaporan/105172/empty,Uruk Pendedahen,Batukarang,6490000,7282000,13-11-2023,792000
318,776,https://mpo.psp.pertanian.go.id/v.5.1/pelaporan/105173/empty,Kubang Lancing,Batukarang,5900000,6620000,13-11-2023,720000
319,777,https://mpo.psp.pertanian.go.id/v.5.1/pelaporan/105174/empty,Gajah Kuning,Cimbang,5900000,6620000,13-11-2023,720000
320,778,https://mpo.psp.pertanian.go.id/v.5.1/pelaporan/105175/empty,Si Ikur-ikur,Cimbang,5900000,6620000,13-11-2023,720000
321,779,https://mpo.psp.pertanian.go.id/v.5.1/pelaporan/105177/empty,Kasumpat,Cimbang,6195000,6951000,13-11-2023,756000
322,780,https://mpo.psp.pertanian.go.id/v.5.1/pelaporan/105178/empty,Gamber-gamber,Cimbang,6490000,7282000,13-11-2023,792000
323,781,https://mpo.psp.pertanian.go.id/v.5.1/pelaporan/105179/empty,Lompaten,Ujung Payung,5900000,6620000,13-11-2023,720000
324,782,https://mpo.psp.pertanian.go.id/v.5.1/pelaporan/105180/empty,Kuta Bangun,Ujung Payung,6490000,7282000,13-11-2023,792000
325,783,https://mpo.psp.pertanian.go.id/v.5.1/pelaporan/105181/empty,Panggong,Ujung Payung,5900000,6620000,13-11-2023,720000
326,784,https://mpo.psp.pertanian.go.id/v.5.1/pelaporan/105182/empty,Lepar,Ujung Payung,5900000,6620000,13-11-2023,720000
327,785,https://mpo.psp.pertanian.go.id/v.5.1/pelaporan/105183/empty,Pasar Pinter,Gurukinayan,4425000,4965000,13-11-2023,540000
328,786,https://mpo.psp.pertanian.go.id/v.5.1/pelaporan/105184/empty,Bakal Buhara,Gurukinayan,4130000,4634000,13-11-2023,504000
329,787,https://mpo.psp.pertanian.go.id/v.5.1/pelaporan/105185/empty,Mbiar Rutang,Gurukinayan,3540000,3972000,13-11-2023,432000
330,788,https://mpo.psp.pertanian.go.id/v.5.1/pelaporan/105186/empty,Sepinggan,Gurukinayan,4425000,4965000,13-11-2023,540000
331,789,https://mpo.psp.pertanian.go.id/v.5.1/pelaporan/105187/empty,Jeruk Malem,Gurukinayan,4720000,5296000,13-11-2023,576000
332,790,https://mpo.psp.pertanian.go.id/v.5.1/pelaporan/105188/empty,Siberteng,Gurukinayan,4425000,4965000,13-11-2023,540000
333,791,https://mpo.psp.pertanian.go.id/v.5.1/pelaporan/105189/empty,Pegegen 1,Gurukinayan,5310000,5958000,13-11-2023,648000
334,792,https://mpo.psp.pertanian.go.id/v.5.1/pelaporan/105190/empty,Buluh Lubang,Gurubenua,4425000,4965000,08-11-2023,540000
335,793,https://mpo.psp.pertanian.go.id/v.5.1/pelaporan/105191/empty,Lau Ngecih,Gurubenua,4425000,4965000,08-11-2023,540000
336,794,https://mpo.psp.pertanian.go.id/v.5.1/pelaporan/105193/empty,Perjalangen,Gurubenua,4425000,4965000,08-11-2023,540000
337,795,https://mpo.psp.pertanian.go.id/v.5.1/pelaporan/105194/empty,Juma Ndelkih,Gurubenua,4425000,4965000,08-11-2023,540000
338,796,https://mpo.psp.pertanian.go.id/v.5.1/pelaporan/105195/empty,Perjalangen Kawat,Gurubenua,4425000,4965000,08-11-2023,540000
339,797,https://mpo.psp.pertanian.go.id/v.5.1/pelaporan/105196/empty,Perjalangen Kaban Tua,Gurubenua,4425000,4965000,08-11-2023,540000
340,798,https://mpo.psp.pertanian.go.id/v.5.1/pelaporan/105197/empty,Perjalangen Kitik,Gurubenua,4425000,4965000,08-11-2023,540000
341,799,https://mpo.psp.pertanian.go.id/v.5.1/pelaporan/105198/empty,Ujung Suka I,Gurubenua,4425000,4965000,08-11-2023,540000
342,800,https://mpo.psp.pertanian.go.id/v.5.1/pelaporan/105199/empty,Ujung Suka II,Gurubenua,4425000,4965000,08-11-2023,540000
343,801,https://mpo.psp.pertanian.go.id/v.5.1/pelaporan/105200/empty,Tiga Bum-bum,Gurubenua,4425000,4965000,08-11-2023,540000
344,802,https://mpo.psp.pertanian.go.id/v.5.1/pelaporan/105201/empty,Juma Paku,Gurubenua,4425000,4965000,08-11-2023,540000
345,803,https://mpo.psp.pertanian.go.id/v.5.1/pelaporan/105202/empty,Juma Nangka,Gurubenua,4425000,4965000,08-11-2023,540000
346,804,https://mpo.psp.pertanian.go.id/v.5.1/pelaporan/105203/empty,Tambal,Gurubenua,4425000,4965000,08-11-2023,540000
347,805,https://mpo.psp.pertanian.go.id/v.5.1/pelaporan/105204/empty,Tambak Mbelang,Gurubenua,4425000,4965000,08-11-2023,540000
348,806,https://mpo.psp.pertanian.go.id/v.5.1/pelaporan/105205/empty,Taneh Gara,Gurubenua,8850000,9930000,08-11-2023,1080000
349,807,https://mpo.psp.pertanian.go.id/v.5.1/pelaporan/105206/empty,Pola Macem,Gurubenua,8850000,9930000,08-11-2023,1080000
350,808,https://mpo.psp.pertanian.go.id/v.5.1/pelaporan/105207/empty,Rukun Tani,Sarimunte,7375000,8275000,08-11-2023,900000
351,809,https://mpo.psp.pertanian.go.id/v.5.1/pelaporan/105208/empty,Arih Ersada,Sarimunte,5900000,6620000,08-11-2023,720000
352,810,https://mpo.psp.pertanian.go.id/v.5.1/pelaporan/105209/empty,Lanogan,Sarimunte,5900000,6620000,08-11-2023,720000
353,811,https://mpo.psp.pertanian.go.id/v.5.1/pelaporan/105210/empty,Cingkam,Sarimunte,6490000,7282000,08-11-2023,792000
354,812,https://mpo.psp.pertanian.go.id/v.5.1/pelaporan/105211/empty,Nanggok Si Page Mbuah,Sarimunte,6490000,7282000,08-11-2023,792000
355,813,https://mpo.psp.pertanian.go.id/v.5.1/pelaporan/105212/empty,Kendit,Sarimunte,8850000,9930000,08-11-2023,1080000
356,814,https://mpo.psp.pertanian.go.id/v.5.1/pelaporan/105213/empty,Petani Jaya,Sarimunte,7080000,7944000,08-11-2023,864000
357,815,https://mpo.psp.pertanian.go.id/v.5.1/pelaporan/105214/empty,Simulih Karaben,Sarimunte,7080000,7944000,08-11-2023,864000
358,816,https://mpo.psp.pertanian.go.id/v.5.1/pelaporan/105215/empty,Sada Perarih,Sarimunte,6490000,7282000,08-11-2023,792000
359,817,https://mpo.psp.pertanian.go.id/v.5.1/pelaporan/105216/empty,Sangap Encari,Sarimunte,5900000,6620000,08-11-2023,720000
360,818,https://mpo.psp.pertanian.go.id/v.5.1/pelaporan/105217/empty,Juma La Erbaleng,Sarimunte,6490000,7282000,08-11-2023,792000
361,819,https://mpo.psp.pertanian.go.id/v.5.1/pelaporan/105218/empty,Cantik Merah,Sarimunte,6490000,7282000,08-11-2023,792000
362,820,https://mpo.psp.pertanian.go.id/v.5.1/pelaporan/105219/empty,Sipuhu-Puhu,Sarimunte,5900000,6620000,08-11-2023,720000
363,821,https://mpo.psp.pertanian.go.id/v.5.1/pelaporan/105220/empty,Paya Lancing II,Kutambaru,6490000,7282000,08-11-2023,792000
364,822,https://mpo.psp.pertanian.go.id/v.5.1/pelaporan/105221/empty,Taling babo,Kutambaru,7080000,7944000,08-11-2023,864000
365,823,https://mpo.psp.pertanian.go.id/v.5.1/pelaporan/105222/empty,Gumbelin,Kutambaru,5900000,6620000,08-11-2023,720000
366,824,https://mpo.psp.pertanian.go.id/v.5.1/pelaporan/105223/empty,Paya Lancing I,Kutambaru,6195000,6951000,08-11-2023,756000
367,825,https://mpo.psp.pertanian.go.id/v.5.1/pelaporan/105224/empty,Binara 2,Kutambaru,6490000,7282000,08-11-2023,792000
368,826,https://mpo.psp.pertanian.go.id/v.5.1/pelaporan/105225/empty,Termurmur,Kutambaru,6785000,7613000,08-11-2023,828000
369,827,https://mpo.psp.pertanian.go.id/v.5.1/pelaporan/105226/empty,Ora Et Labora,Kutambaru,7080000,7944000,08-11-2023,864000
370,828,https://mpo.psp.pertanian.go.id/v.5.1/pelaporan/105227/empty,Jumanta Ras,Kutambaru,7375000,8275000,08-11-2023,900000
371,829,https://mpo.psp.pertanian.go.id/v.5.1/pelaporan/105228/empty,Paya Mbelang,Tanjung Beringin,7080000,7944000,08-11-2023,864000
372,830,https://mpo.psp.pertanian.go.id/v.5.1/pelaporan/105230/empty,Mandah Binara,Tanjung Beringin,7375000,8275000,08-11-2023,900000
373,831,https://mpo.psp.pertanian.go.id/v.5.1/pelaporan/105231/empty,Kerangen Tabu,Tanjung Beringin,7670000,8606000,08-11-2023,936000
374,832,https://mpo.psp.pertanian.go.id/v.5.1/pelaporan/105232/empty,Mandah,Munte,7375000,8275000,08-11-2023,900000
375,833,https://mpo.psp.pertanian.go.id/v.5.1/pelaporan/105234/empty,Pestap,Munte,7375000,8275000,08-11-2023,900000
376,834,https://mpo.psp.pertanian.go.id/v.5.1/pelaporan/105235/empty,Beringin Jaya,Munte,7375000,8275000,08-11-2023,900000
377,835,https://mpo.psp.pertanian.go.id/v.5.1/pelaporan/105237/empty,SMP,Munte,7375000,8275000,08-11-2023,900000
378,836,https://mpo.psp.pertanian.go.id/v.5.1/pelaporan/105238/empty,Nangka 2,Munte,7375000,8275000,08-11-2023,900000
379,837,https://mpo.psp.pertanian.go.id/v.5.1/pelaporan/105239/empty,Bunga Ncuri,Munte,7375000,8275000,08-11-2023,900000
380,838,https://mpo.psp.pertanian.go.id/v.5.1/pelaporan/105240/empty,Lau Sekalak,Munte,7375000,8275000,08-11-2023,900000
381,839,https://mpo.psp.pertanian.go.id/v.5.1/pelaporan/105241/empty,Buah Kitik,Barung Kersap,7375000,8275000,08-11-2023,900000
382,840,https://mpo.psp.pertanian.go.id/v.5.1/pelaporan/105242/empty,Kenjahe I,Barung Kersap,7375000,8275000,08-11-2023,900000
383,841,https://mpo.psp.pertanian.go.id/v.5.1/pelaporan/105243/empty,Cekdam,Barung Kersap,7375000,8275000,08-11-2023,900000
384,842,https://mpo.psp.pertanian.go.id/v.5.1/pelaporan/105244/empty,Tanjung Meger,Barung Kersap,7375000,8275000,08-11-2023,900000
385,843,https://mpo.psp.pertanian.go.id/v.5.1/pelaporan/105245/empty,Panggung Baru I,Barung Kersap,7375000,8275000,08-11-2023,900000
386,844,https://mpo.psp.pertanian.go.id/v.5.1/pelaporan/105246/empty,Talun Bengkala,Biaknampe,5900000,6620000,08-11-2023,720000
387,845,https://mpo.psp.pertanian.go.id/v.5.1/pelaporan/105247/empty,Rakit Lau Serundi,Biaknampe,7080000,7944000,08-11-2023,864000
388,846,https://mpo.psp.pertanian.go.id/v.5.1/pelaporan/105248/empty,Juma Lepar,Kaban Tua,5900000,6620000,08-11-2023,720000
389,847,https://mpo.psp.pertanian.go.id/v.5.1/pelaporan/105251/empty,Sabah Jahe,Kaban Tua,5900000,6620000,08-11-2023,720000
390,848,https://mpo.psp.pertanian.go.id/v.5.1/pelaporan/105252/empty,Sabah Kendit,Kaban Tua,7670000,8606000,08-11-2023,936000
391,849,https://mpo.psp.pertanian.go.id/v.5.1/pelaporan/105253/empty,Simpang Telu,Kaban Tua,6490000,7282000,08-11-2023,792000
392,850,https://mpo.psp.pertanian.go.id/v.5.1/pelaporan/105254/empty,Lau Ersabung,Kaban Tua,6195000,6951000,08-11-2023,756000
393,851,https://mpo.psp.pertanian.go.id/v.5.1/pelaporan/105255/empty,Baluren Tengah,Kaban Tua,7080000,7944000,08-11-2023,864000
394,852,https://mpo.psp.pertanian.go.id/v.5.1/pelaporan/105256/empty,Arih Ersada,Gunung Saribu,7375000,8275000,08-11-2023,900000
395,853,https://mpo.psp.pertanian.go.id/v.5.1/pelaporan/105257/empty,Kekelengen,Gunung Saribu,7375000,8275000,08-11-2023,900000
396,854,https://mpo.psp.pertanian.go.id/v.5.1/pelaporan/105258/empty,Sue Arih,Gunung Saribu,12390000,13902000,08-11-2023,1512000
397,855,https://mpo.psp.pertanian.go.id/v.5.1/pelaporan/105260/empty,Rengo,Gunung Saribu,13570000,15226000,08-11-2023,1656000
398,856,https://mpo.psp.pertanian.go.id/v.5.1/pelaporan/105261/empty,Maju Bersama,Gunung Saribu,10325000,11585000,08-11-2023,1260000
399,857,https://mpo.psp.pertanian.go.id/v.5.1/pelaporan/105262/empty,Busuh,Gunung Saribu,5900000,6620000,08-11-2023,720000
400,858,https://mpo.psp.pertanian.go.id/v.5.1/pelaporan/105263/empty,Baluren,Kuta Gerat,7670000,8606000,08-11-2023,936000
401,859,https://mpo.psp.pertanian.go.id/v.5.1/pelaporan/105264/empty,Tambal,Kuta Gerat,7080000,7944000,08-11-2023,864000
402,860,https://mpo.psp.pertanian.go.id/v.5.1/pelaporan/105265/empty,Buluh Kandang,Sukarame,7375000,8275000,08-11-2023,900000
403,861,https://mpo.psp.pertanian.go.id/v.5.1/pelaporan/105266/empty,Lau Tuba,Sukarame,5900000,6620000,08-11-2023,720000
404,862,https://mpo.psp.pertanian.go.id/v.5.1/pelaporan/105267/empty,Berneh Mbagas,Singgamanik,5900000,6620000,08-11-2023,720000
405,863,https://mpo.psp.pertanian.go.id/v.5.1/pelaporan/105269/empty,Jambu,Singgamanik,6490000,7282000,08-11-2023,792000
406,864,https://mpo.psp.pertanian.go.id/v.5.1/pelaporan/105270/empty,Parik Deras,Singgamanik,5900000,6620000,08-11-2023,720000
407,865,https://mpo.psp.pertanian.go.id/v.5.1/pelaporan/105271/empty,Genting,Singgamanik,5900000,6620000,08-11-2023,720000
408,866,https://mpo.psp.pertanian.go.id/v.5.1/pelaporan/105272/empty,Kuta tengah,Pertumbungen,7375000,8275000,08-11-2023,900000
409,867,https://mpo.psp.pertanian.go.id/v.5.1/pelaporan/105273/empty,Jumanta Ras,Pertumbungen,7080000,7944000,08-11-2023,864000
410,868,https://mpo.psp.pertanian.go.id/v.5.1/pelaporan/105274/empty,Lau Bengkuang,Pertumbungen,7375000,8275000,08-11-2023,900000
411,869,https://mpo.psp.pertanian.go.id/v.5.1/pelaporan/105275/empty,Batu Jagat,Pertumbungen,5900000,6620000,08-11-2023,720000
412,870,https://mpo.psp.pertanian.go.id/v.5.1/pelaporan/105276/empty,Rimo Mukur,Pertumbungen,8850000,9930000,08-11-2023,1080000
413,871,https://mpo.psp.pertanian.go.id/v.5.1/pelaporan/105277/empty,Juma Lepat,Pertumbungen,7375000,8275000,08-11-2023,900000
414,872,https://mpo.psp.pertanian.go.id/v.5.1/pelaporan/105278/empty,Sabah Bursak,Buluhnaman,5900000,6620000,08-11-2023,720000
415,873,https://mpo.psp.pertanian.go.id/v.5.1/pelaporan/105279/empty,Juma Ampeng,Buluhnaman,5900000,6620000,08-11-2023,720000
416,874,https://mpo.psp.pertanian.go.id/v.5.1/pelaporan/105280/empty,Sabah Kenjahe,Buluhnaman,5900000,6620000,08-11-2023,720000
417,875,https://mpo.psp.pertanian.go.id/v.5.1/pelaporan/105281/empty,Sabah Tamale,Buluhnaman,5900000,6620000,08-11-2023,720000
418,876,https://mpo.psp.pertanian.go.id/v.5.1/pelaporan/105282/empty,Tanjong Bunga,Selakkar,5900000,6620000,08-11-2023,720000
419,877,https://mpo.psp.pertanian.go.id/v.5.1/pelaporan/105283/empty,Lau Pola Pola,Selakkar,6490000,7282000,08-11-2023,792000
420,878,https://mpo.psp.pertanian.go.id/v.5.1/pelaporan/105284/empty,Paya Tabu,Selakkar,5900000,6620000,08-11-2023,720000
421,879,https://mpo.psp.pertanian.go.id/v.5.1/pelaporan/105285/empty,Tanjung Besi,Selakkar,6785000,7613000,08-11-2023,828000
422,880,https://mpo.psp.pertanian.go.id/v.5.1/pelaporan/105286/empty,Juma Kuta Suah,Kuta Suah,8850000,9930000,08-11-2023,1080000
423,881,https://mpo.psp.pertanian.go.id/v.5.1/pelaporan/105287/empty,Juma Kerangen,Kuta Suah,10030000,11254000,08-11-2023,1224000
424,882,https://mpo.psp.pertanian.go.id/v.5.1/pelaporan/105288/empty,Lau Rengit,Nageri,7375000,8275000,08-11-2023,900000
425,883,https://mpo.psp.pertanian.go.id/v.5.1/pelaporan/105289/empty,Lau Kuta Kenjahe,Nageri,5900000,6620000,08-11-2023,720000
426,884,https://mpo.psp.pertanian.go.id/v.5.1/pelaporan/105290/empty,Juma Kenjulu II,Nageri,5900000,6620000,08-11-2023,720000
427,885,https://mpo.psp.pertanian.go.id/v.5.1/pelaporan/105291/empty,Lau Gadin,Parimbalang,7375000,8275000,08-11-2023,900000
428,886,https://mpo.psp.pertanian.go.id/v.5.1/pelaporan/105292/empty,Gelugur,Parimbalang,7375000,8275000,08-11-2023,900000
430,888,https://mpo.psp.pertanian.go.id/v.5.1/pelaporan/105294/empty,Gunung Dekah,Gunung Manumpak,6490000,7282000,08-11-2023,792000
431,889,https://mpo.psp.pertanian.go.id/v.5.1/pelaporan/105295/empty,Sabah Elok,Gunung Manumpak,7080000,7944000,08-11-2023,864000
432,890,https://mpo.psp.pertanian.go.id/v.5.1/pelaporan/105296/empty,Ganepo,Gunung Manumpak,7670000,8606000,08-11-2023,936000
433,891,https://mpo.psp.pertanian.go.id/v.5.1/pelaporan/105297/empty,Juma Gelong I,Kineppen,8850000,9930000,08-11-2023,1080000
434,892,https://mpo.psp.pertanian.go.id/v.5.1/pelaporan/105298/empty,Juma Gelong Ii,Kineppen,7375000,8275000,08-11-2023,900000
435,893,https://mpo.psp.pertanian.go.id/v.5.1/pelaporan/105299/empty,Juma Bungke,Kineppen,8850000,9930000,08-11-2023,1080000
436,894,https://mpo.psp.pertanian.go.id/v.5.1/pelaporan/105300/empty,Suka Lapping,Kineppen,10030000,11254000,08-11-2023,1224000
437,895,https://mpo.psp.pertanian.go.id/v.5.1/pelaporan/105301/empty,Arih Ersada,Bandar Meriah,8850000,9930000,08-11-2023,1080000
438,896,https://mpo.psp.pertanian.go.id/v.5.1/pelaporan/105302/empty,Mbincar Bungana,Bandar Meriah,9440000,10592000,08-11-2023,1152000
440,898,https://mpo.psp.pertanian.go.id/v.5.1/pelaporan/105304/empty,Bunga Ncole,Bandar Meriah,11210000,12578000,08-11-2023,1368000
441,899,https://mpo.psp.pertanian.go.id/v.5.1/pelaporan/105305/empty,Juma Pasar,Bandar Meriah,4425000,4965000,08-11-2023,540000
442,900,https://mpo.psp.pertanian.go.id/v.5.1/pelaporan/105306/empty,Sageng,Sugihen,6490000,7282000,08-11-2023,792000
443,901,https://mpo.psp.pertanian.go.id/v.5.1/pelaporan/105307/empty,Jabi Jabi Pulo,Sugihen,6490000,7282000,08-11-2023,792000
444,902,https://mpo.psp.pertanian.go.id/v.5.1/pelaporan/105308/empty,Sampuren Tani,Sugihen,5900000,6620000,08-11-2023,720000
445,903,https://mpo.psp.pertanian.go.id/v.5.1/pelaporan/105310/empty,Lau Penggayon,Sugihen,5900000,6620000,08-11-2023,720000
446,904,https://mpo.psp.pertanian.go.id/v.5.1/pelaporan/105311/empty,Taneh Mate,Sugihen,5900000,6620000,08-11-2023,720000
447,905,https://mpo.psp.pertanian.go.id/v.5.1/pelaporan/105312/empty,Kerangen Tambak Ii,Sugihen,7375000,8275000,08-11-2023,900000
448,906,https://mpo.psp.pertanian.go.id/v.5.1/pelaporan/105313/empty,Belinen,Pernantin,8850000,9930000,08-11-2023,1080000
449,907,https://mpo.psp.pertanian.go.id/v.5.1/pelaporan/105314/empty,Belinun Cemerlang,Pernantin,8850000,9930000,08-11-2023,1080000
450,908,https://mpo.psp.pertanian.go.id/v.5.1/pelaporan/105315/empty,Tiga Siempat,Pernantin,11800000,13240000,08-11-2023,1440000
451,909,https://mpo.psp.pertanian.go.id/v.5.1/pelaporan/105316/empty,Kebayaken,Sigenderang,5900000,6620000,08-11-2023,720000
452,910,https://mpo.psp.pertanian.go.id/v.5.1/pelaporan/105317/empty,Reben Mbelang,Sigenderang,6490000,7282000,08-11-2023,792000
453,911,https://mpo.psp.pertanian.go.id/v.5.1/pelaporan/105319/empty,Lau Galoh,Sigenderang,5900000,6620000,08-11-2023,720000
454,912,https://mpo.psp.pertanian.go.id/v.5.1/pelaporan/105320/empty,Rm Murah Rejeki,Sigenderang,6490000,7282000,08-11-2023,792000
455,913,https://mpo.psp.pertanian.go.id/v.5.1/pelaporan/105321/empty,Kaban Coli,Sigenderang,7375000,8275000,08-11-2023,900000
456,914,https://mpo.psp.pertanian.go.id/v.5.1/pelaporan/105322/empty,Uruk Terong,Nageri,7375000,8275000,08-11-2023,900000
457,915,https://mpo.psp.pertanian.go.id/v.5.1/pelaporan/105323/empty,Namo Pulut,Nageri,5900000,6620000,08-11-2023,720000
458,916,https://mpo.psp.pertanian.go.id/v.5.1/pelaporan/105324/empty,Lau Sandar,Nageri,7080000,7944000,08-11-2023,864000
459,917,https://mpo.psp.pertanian.go.id/v.5.1/pelaporan/105325/empty,Lau Bungke,Nageri,7670000,8606000,08-11-2023,936000
460,918,https://mpo.psp.pertanian.go.id/v.5.1/pelaporan/105326/empty,Buah Tubung,Nageri,8850000,9930000,08-11-2023,1080000
461,919,https://mpo.psp.pertanian.go.id/v.5.1/pelaporan/105327/empty,Tani Jaya,Nageri,8260000,9268000,08-11-2023,1008000
462,920,https://mpo.psp.pertanian.go.id/v.5.1/pelaporan/105331/empty,Kendit Nangka,Nageri,7375000,8275000,08-11-2023,900000
463,921,https://mpo.psp.pertanian.go.id/v.5.1/pelaporan/105332/empty,Pator,Kutagugung,5900000,6620000,08-11-2023,720000
465,923,https://mpo.psp.pertanian.go.id/v.5.1/pelaporan/105334/empty,Arih Ersada,Kutagugung,5900000,6620000,08-11-2023,720000
466,924,https://mpo.psp.pertanian.go.id/v.5.1/pelaporan/105335/empty,Jamanik,Kutagugung,5900000,6620000,08-11-2023,720000
467,925,https://mpo.psp.pertanian.go.id/v.5.1/pelaporan/105337/empty,Picak-picak,Kutagugung,5900000,6620000,08-11-2023,720000
468,926,https://mpo.psp.pertanian.go.id/v.5.1/pelaporan/105338/empty,Kersik,Kutagugung,6490000,7282000,08-11-2023,792000
469,927,https://mpo.psp.pertanian.go.id/v.5.1/pelaporan/105339/empty,Rimo Kayu,Kutagugung,5900000,6620000,08-11-2023,720000
470,928,https://mpo.psp.pertanian.go.id/v.5.1/pelaporan/105340/empty,Wanita Kreatif,Kutagugung,5900000,6620000,08-11-2023,720000
471,929,https://mpo.psp.pertanian.go.id/v.5.1/pelaporan/105341/empty,Taneh Mate,Sukababo,5900000,6620000,08-11-2023,720000
472,930,https://mpo.psp.pertanian.go.id/v.5.1/pelaporan/105342/empty,Paya Montan,Batu Mamak,5900000,6620000,08-11-2023,720000
473,931,https://mpo.psp.pertanian.go.id/v.5.1/pelaporan/105343/empty,Biak Nampe,Batu Mamak,6490000,7282000,08-11-2023,792000
474,932,https://mpo.psp.pertanian.go.id/v.5.1/pelaporan/105345/empty,Kenjahe Kasumpat,Batu Mamak,5900000,6620000,08-11-2023,720000
475,933,https://mpo.psp.pertanian.go.id/v.5.1/pelaporan/105346/empty,Uruk Kenjulu,Batu Mamak,5900000,6620000,08-11-2023,720000
476,934,https://mpo.psp.pertanian.go.id/v.5.1/pelaporan/105347/empty,Putri Srikandi,Batu Mamak,5900000,6620000,08-11-2023,720000
477,935,https://mpo.psp.pertanian.go.id/v.5.1/pelaporan/105348/empty,Uruk Gumbelen,Batu Mamak,5900000,6620000,08-11-2023,720000
478,936,https://mpo.psp.pertanian.go.id/v.5.1/pelaporan/105349/empty,Juma Kenjahe,Jandi,5900000,6620000,08-11-2023,720000
479,937,https://mpo.psp.pertanian.go.id/v.5.1/pelaporan/105350/empty,Sabah Kenjulu,Jandi,6490000,7282000,08-11-2023,792000
480,938,https://mpo.psp.pertanian.go.id/v.5.1/pelaporan/105351/empty,Pulu Balang,Jandi,5900000,6620000,08-11-2023,720000
481,939,https://mpo.psp.pertanian.go.id/v.5.1/pelaporan/105353/empty,Sabah Kendit,Jandi,5900000,6620000,08-11-2023,720000
482,940,https://mpo.psp.pertanian.go.id/v.5.1/pelaporan/105354/empty,Sabah Gugung,Jandi,5900000,6620000,08-11-2023,720000
483,941,https://mpo.psp.pertanian.go.id/v.5.1/pelaporan/105356/empty,Sembergo,Juhar Tarigan,4425000,4965000,08-11-2023,540000
484,942,https://mpo.psp.pertanian.go.id/v.5.1/pelaporan/105357/empty,Paya Ondan,Juhar Perangin-angin,2950000,3310000,08-11-2023,360000
485,943,https://mpo.psp.pertanian.go.id/v.5.1/pelaporan/105358/empty,Dalu Dalu,Juhar Perangin-angin,5900000,6620000,08-11-2023,720000
486,944,https://mpo.psp.pertanian.go.id/v.5.1/pelaporan/105359/empty,Galumpang,Juhar Perangin-angin,4425000,4965000,08-11-2023,540000
487,945,https://mpo.psp.pertanian.go.id/v.5.1/pelaporan/105360/empty,Pancur Liang,Juhar Perangin-angin,5900000,6620000,08-11-2023,720000
488,946,https://mpo.psp.pertanian.go.id/v.5.1/pelaporan/105362/empty,Ondan,Juhar Perangin-angin,5900000,6620000,08-11-2023,720000
489,947,https://mpo.psp.pertanian.go.id/v.5.1/pelaporan/105363/empty,Dalu-Dalu Jahe,Juhar Perangin-angin,5900000,6620000,08-11-2023,720000
490,948,https://mpo.psp.pertanian.go.id/v.5.1/pelaporan/105364/empty,Rambemelas,Gunung Juhar,6490000,7282000,08-11-2023,792000
491,949,https://mpo.psp.pertanian.go.id/v.5.1/pelaporan/105365/empty,Cucupak,Juhar Ginting,6490000,7282000,08-11-2023,792000
492,950,https://mpo.psp.pertanian.go.id/v.5.1/pelaporan/105366/empty,Merga Silima,Juhar Ginting,5900000,6620000,08-11-2023,720000
493,951,https://mpo.psp.pertanian.go.id/v.5.1/pelaporan/105368/empty,Torbis,Juhar Ginting,5900000,6620000,08-11-2023,720000
494,952,https://mpo.psp.pertanian.go.id/v.5.1/pelaporan/105369/empty,Kenangan,Juhar Ginting,5900000,6620000,08-11-2023,720000
495,953,https://mpo.psp.pertanian.go.id/v.5.1/pelaporan/105371/empty,Uruk Berteng,Juhar Ginting,2950000,3310000,08-11-2023,360000
496,954,https://mpo.psp.pertanian.go.id/v.5.1/pelaporan/105372/empty,Arih ersada,Juhar Ginting,2950000,3310000,08-11-2023,360000
497,955,https://mpo.psp.pertanian.go.id/v.5.1/pelaporan/105373/empty,Cepen,Juhar Ginting,2950000,3310000,08-11-2023,360000
498,956,https://mpo.psp.pertanian.go.id/v.5.1/pelaporan/105374/empty,Karang Kuda,Juhar Ginting,2950000,3310000,08-11-2023,360000
499,957,https://mpo.psp.pertanian.go.id/v.5.1/pelaporan/105375/empty,Tanjong,Juhar Ginting Sadanioga,4425000,4965000,08-11-2023,540000
500,958,https://mpo.psp.pertanian.go.id/v.5.1/pelaporan/105376/empty,Mbuah Page,Juhar Ginting Sadanioga,2950000,3310000,08-11-2023,360000
501,959,https://mpo.psp.pertanian.go.id/v.5.1/pelaporan/105378/empty,Ondan,Juhar Ginting Sadanioga,5900000,6620000,08-11-2023,720000
502,960,https://mpo.psp.pertanian.go.id/v.5.1/pelaporan/105380/empty,Gelora Tani,Kutambelin,5900000,6620000,08-11-2023,720000
503,961,https://mpo.psp.pertanian.go.id/v.5.1/pelaporan/105381/empty,Sejahtera Tani,Kutambelin,5900000,6620000,08-11-2023,720000
504,962,https://mpo.psp.pertanian.go.id/v.5.1/pelaporan/105382/empty,Tiga Serangkai,Kutambelin,5900000,6620000,08-11-2023,720000
505,963,https://mpo.psp.pertanian.go.id/v.5.1/pelaporan/105383/empty,Gelora Tani II,Kutambelin,5900000,6620000,08-11-2023,720000
506,964,https://mpo.psp.pertanian.go.id/v.5.1/pelaporan/105384/empty,Jaya Tani,Kutambelin,6490000,7282000,08-11-2023,792000
507,965,https://mpo.psp.pertanian.go.id/v.5.1/pelaporan/105386/empty,Bersama,Lau Lingga,8850000,9930000,08-11-2023,1080000
508,966,https://mpo.psp.pertanian.go.id/v.5.1/pelaporan/105387/empty,Harapan tani,Buluh Pancur,7375000,8275000,08-11-2023,900000
509,967,https://mpo.psp.pertanian.go.id/v.5.1/pelaporan/105389/empty,Marikena,Lau Kidupen,7670000,8606000,08-11-2023,936000
510,968,https://mpo.psp.pertanian.go.id/v.5.1/pelaporan/105390/empty,Arih Ersada,Naga,4425000,4965000,08-11-2023,540000
511,969,https://mpo.psp.pertanian.go.id/v.5.1/pelaporan/105391/empty,Lau Daling,Namosuro,7375000,8275000,08-11-2023,900000
512,970,https://mpo.psp.pertanian.go.id/v.5.1/pelaporan/105392/empty,Merga Silima,Namosuro,7080000,7944000,08-11-2023,864000
513,971,https://mpo.psp.pertanian.go.id/v.5.1/pelaporan/105394/empty,Namo Lembu,Pasar Baru,5900000,6620000,08-11-2023,720000
516,974,https://mpo.psp.pertanian.go.id/v.5.1/pelaporan/105397/empty,Kendit,Mbetong,5900000,6620000,08-11-2023,720000
517,975,https://mpo.psp.pertanian.go.id/v.5.1/pelaporan/105398/empty,Lengo Parik Bengkala,Mbetong,5900000,6620000,08-11-2023,720000
518,976,https://mpo.psp.pertanian.go.id/v.5.1/pelaporan/105400/empty,Tenggiring,Mbetong,5900000,6620000,08-11-2023,720000
520,978,https://mpo.psp.pertanian.go.id/v.5.1/pelaporan/105403/empty,Kenderan,Mbetong,5900000,6620000,08-11-2023,720000
521,979,https://mpo.psp.pertanian.go.id/v.5.1/pelaporan/105404/empty,Terneh,Mbetong,7375000,8275000,08-11-2023,900000
522,980,https://mpo.psp.pertanian.go.id/v.5.1/pelaporan/105405/empty,Pandan Jaya,Mbetong,5900000,6620000,08-11-2023,720000
523,981,https://mpo.psp.pertanian.go.id/v.5.1/pelaporan/105406/empty,Lau Simalem,Bekilang,4425000,4965000,08-11-2023,540000
525,983,https://mpo.psp.pertanian.go.id/v.5.1/pelaporan/105409/empty,Bunga Benih,Serdang,4130000,4634000,10-11-2023,504000
526,984,https://mpo.psp.pertanian.go.id/v.5.1/pelaporan/105410/empty,Juma Julun,Serdang,3540000,3972000,10-11-2023,432000
527,985,https://mpo.psp.pertanian.go.id/v.5.1/pelaporan/105411/empty,Kembang Tani,Serdang,3540000,3972000,10-11-2023,432000
528,986,https://mpo.psp.pertanian.go.id/v.5.1/pelaporan/105413/empty,Juma Jahen,Serdang,3540000,3972000,10-11-2023,432000
529,987,https://mpo.psp.pertanian.go.id/v.5.1/pelaporan/105414/empty,Ersada Arih,Serdang,3540000,3972000,10-11-2023,432000
530,988,https://mpo.psp.pertanian.go.id/v.5.1/pelaporan/105415/empty,Bunga Sapa,Serdang,3835000,4303000,10-11-2023,468000
532,990,https://mpo.psp.pertanian.go.id/v.5.1/pelaporan/105418/empty,Rudang Mayang,Serdang,3245000,3641000,10-11-2023,396000
533,991,https://mpo.psp.pertanian.go.id/v.5.1/pelaporan/105419/empty,Sabah Tineka,Serdang,3540000,3972000,10-11-2023,432000
534,992,https://mpo.psp.pertanian.go.id/v.5.1/pelaporan/105420/empty,Sukamaju,Serdang,2950000,3310000,10-11-2023,360000
535,993,https://mpo.psp.pertanian.go.id/v.5.1/pelaporan/105422/empty,Makmur Sejahtera,Penampen,4130000,4634000,10-11-2023,504000
536,994,https://mpo.psp.pertanian.go.id/v.5.1/pelaporan/105423/empty,Bunga Mawar,Penampen,3540000,3972000,10-11-2023,432000
537,995,https://mpo.psp.pertanian.go.id/v.5.1/pelaporan/105425/empty,Cinta Kasih,Penampen,2655000,2979000,10-11-2023,324000
538,996,https://mpo.psp.pertanian.go.id/v.5.1/pelaporan/105426/empty,Juma Julun,Penampen,4720000,5296000,10-11-2023,576000
539,997,https://mpo.psp.pertanian.go.id/v.5.1/pelaporan/105427/empty,Bunga Rampai,Penampen,2950000,3310000,10-11-2023,360000
540,998,https://mpo.psp.pertanian.go.id/v.5.1/pelaporan/105428/empty,Bunga Teratai,Penampen,4720000,5296000,10-11-2023,576000
542,1000,https://mpo.psp.pertanian.go.id/v.5.1/pelaporan/105431/empty,Juma Jahen,Penampen,3835000,4303000,10-11-2023,468000
543,1001,https://mpo.psp.pertanian.go.id/v.5.1/pelaporan/105432/empty,Sepinggan,Paribun,1475000,1655000,10-11-2023,180000
545,1003,https://mpo.psp.pertanian.go.id/v.5.1/pelaporan/105434/empty,Juma Bendera,Paribun,1475000,1655000,10-11-2023,180000
546,1004,https://mpo.psp.pertanian.go.id/v.5.1/pelaporan/105436/empty,Juma Becid,Paribun,1475000,1655000,10-11-2023,180000
547,1005,https://mpo.psp.pertanian.go.id/v.5.1/pelaporan/105437/empty,Ulih Latih,Persadanta,1475000,1655000,10-11-2023,180000
549,1007,https://mpo.psp.pertanian.go.id/v.5.1/pelaporan/105440/empty,Bunga Teratai,Persadanta,1475000,1655000,10-11-2023,180000
551,1009,https://mpo.psp.pertanian.go.id/v.5.1/pelaporan/105442/empty,Bunga Ncole,Talimbaru,5900000,6620000,10-11-2023,720000
552,1010,https://mpo.psp.pertanian.go.id/v.5.1/pelaporan/105443/empty,Bunga Ester,Talimbaru,5900000,6620000,10-11-2023,720000
553,1011,https://mpo.psp.pertanian.go.id/v.5.1/pelaporan/105444/empty,Bunga Ros,Talimbaru,5900000,6620000,10-11-2023,720000
554,1012,https://mpo.psp.pertanian.go.id/v.5.1/pelaporan/105446/empty,Bunga Mawar,Talimbaru,5900000,6620000,10-11-2023,720000
555,1013,https://mpo.psp.pertanian.go.id/v.5.1/pelaporan/105448/empty,Bunga Dawa,Talimbaru,5900000,6620000,10-11-2023,720000
556,1014,https://mpo.psp.pertanian.go.id/v.5.1/pelaporan/105449/empty,Bunga Sapa,Talimbaru,5900000,6620000,10-11-2023,720000
557,1015,https://mpo.psp.pertanian.go.id/v.5.1/pelaporan/105450/empty,Bunga Anggrek,Talimbaru,5900000,6620000,10-11-2023,720000
558,1016,https://mpo.psp.pertanian.go.id/v.5.1/pelaporan/105451/empty,Bunga Melati,Talimbaru,5900000,6620000,10-11-2023,720000
559,1017,https://mpo.psp.pertanian.go.id/v.5.1/pelaporan/105452/empty,Bunga Rampe,Talimbaru,5900000,6620000,10-11-2023,720000
560,1018,https://mpo.psp.pertanian.go.id/v.5.1/pelaporan/105453/empty,Bunga Sedap Malam,Talimbaru,5900000,6620000,10-11-2023,720000
561,1019,https://mpo.psp.pertanian.go.id/v.5.1/pelaporan/105454/empty,Bunga Matahari,Talimbaru,5900000,6620000,10-11-2023,720000
562,1020,https://mpo.psp.pertanian.go.id/v.5.1/pelaporan/105455/empty,Bersama,Sinaman,3540000,3972000,10-11-2023,432000
563,1021,https://mpo.psp.pertanian.go.id/v.5.1/pelaporan/105456/empty,Juma Gerat,Sinaman,4425000,4965000,10-11-2023,540000
565,1023,https://mpo.psp.pertanian.go.id/v.5.1/pelaporan/105460/empty,Agro Aronta,Sinaman,6490000,7282000,10-11-2023,792000
566,1024,https://mpo.psp.pertanian.go.id/v.5.1/pelaporan/105461/empty,Berdikari,Sinaman,8850000,9930000,10-11-2023,1080000
567,1025,https://mpo.psp.pertanian.go.id/v.5.1/pelaporan/105462/empty,Usur-Usur,Sinaman,8850000,9930000,10-11-2023,1080000
568,1026,https://mpo.psp.pertanian.go.id/v.5.1/pelaporan/105463/empty,Guaninta,Sinaman,2655000,2979000,10-11-2023,324000
569,1027,https://mpo.psp.pertanian.go.id/v.5.1/pelaporan/105465/empty,Juma Lau Semil,Sinaman,2655000,2979000,10-11-2023,324000
570,1028,https://mpo.psp.pertanian.go.id/v.5.1/pelaporan/105466/empty,Mbuah Page,Sinaman,3540000,3972000,10-11-2023,432000
571,1029,https://mpo.psp.pertanian.go.id/v.5.1/pelaporan/105468/empty,Cinta Karya,Sinaman,3835000,4303000,10-11-2023,468000
572,1030,https://mpo.psp.pertanian.go.id/v.5.1/pelaporan/105469/empty,Kasih Murni,Sinaman,4425000,4965000,10-11-2023,540000
573,1031,https://mpo.psp.pertanian.go.id/v.5.1/pelaporan/105471/empty,Juma Pergendangen,Sarimanis,3540000,3972000,10-11-2023,432000
574,1032,https://mpo.psp.pertanian.go.id/v.5.1/pelaporan/105472/empty,Juma Lepar,Sarimanis,3540000,3972000,10-11-2023,432000
575,1033,https://mpo.psp.pertanian.go.id/v.5.1/pelaporan/105473/empty,Juma Sue Arih Ersada,Sarimanis,3540000,3972000,10-11-2023,432000
576,1034,https://mpo.psp.pertanian.go.id/v.5.1/pelaporan/105474/empty,Juma Galuh,Sarimanis,3540000,3972000,10-11-2023,432000
577,1035,https://mpo.psp.pertanian.go.id/v.5.1/pelaporan/105475/empty,Juma Reba Tengah,Sarimanis,3540000,3972000,10-11-2023,432000
578,1036,https://mpo.psp.pertanian.go.id/v.5.1/pelaporan/105476/empty,Juma Piar -Piar,Sarimanis,3540000,3972000,10-11-2023,432000
579,1037,https://mpo.psp.pertanian.go.id/v.5.1/pelaporan/105478/empty,Juma Uruk - Uruk,Sarimanis,3540000,3972000,10-11-2023,432000
580,1038,https://mpo.psp.pertanian.go.id/v.5.1/pelaporan/105480/empty,Tunas Muda,Barusjahe,3540000,3972000,10-11-2023,432000
581,1039,https://mpo.psp.pertanian.go.id/v.5.1/pelaporan/105481/empty,Beraspinto,Barusjahe,3835000,4303000,10-11-2023,468000
582,1040,https://mpo.psp.pertanian.go.id/v.5.1/pelaporan/105482/empty,Juma Berneh,Barusjahe,3540000,3972000,10-11-2023,432000
583,1041,https://mpo.psp.pertanian.go.id/v.5.1/pelaporan/105483/empty,Persimbun,Barusjahe,4425000,4965000,10-11-2023,540000
584,1042,https://mpo.psp.pertanian.go.id/v.5.1/pelaporan/105484/empty,Bunga Jadi Buah,Barusjahe,4425000,4965000,10-11-2023,540000
585,1043,https://mpo.psp.pertanian.go.id/v.5.1/pelaporan/105486/empty,Rumah Julun,Barusjahe,4130000,4634000,10-11-2023,504000
586,1044,https://mpo.psp.pertanian.go.id/v.5.1/pelaporan/105488/empty,Aronta,Barusjahe,5310000,5958000,10-11-2023,648000
587,1045,https://mpo.psp.pertanian.go.id/v.5.1/pelaporan/105489/empty,Kesain Munte,Barusjahe,2950000,3310000,10-11-2023,360000
588,1046,https://mpo.psp.pertanian.go.id/v.5.1/pelaporan/105490/empty,Makmur Tani,Sukajulu,5310000,5958000,10-11-2023,648000
589,1047,https://mpo.psp.pertanian.go.id/v.5.1/pelaporan/105491/empty,Gunanta Ras,Sukajulu,4720000,5296000,10-11-2023,576000
590,1048,https://mpo.psp.pertanian.go.id/v.5.1/pelaporan/105492/empty,Jumatambak,Rumamis,5605000,6289000,10-11-2023,684000
591,1049,https://mpo.psp.pertanian.go.id/v.5.1/pelaporan/105493/empty,Mbuahpage,Rumamis,4425000,4965000,10-11-2023,540000
592,1050,https://mpo.psp.pertanian.go.id/v.5.1/pelaporan/105495/empty,Tani Jaya,Rumamis,5310000,5958000,10-11-2023,648000
593,1051,https://mpo.psp.pertanian.go.id/v.5.1/pelaporan/105496/empty,Kopimalem,Rumamis,4425000,4965000,10-11-2023,540000
594,1052,https://mpo.psp.pertanian.go.id/v.5.1/pelaporan/105497/empty,Suearih,Rumamis,5310000,5958000,10-11-2023,648000
595,1053,https://mpo.psp.pertanian.go.id/v.5.1/pelaporan/105498/empty,Bunga Mawar,Rumamis,3835000,4303000,10-11-2023,468000
596,1054,https://mpo.psp.pertanian.go.id/v.5.1/pelaporan/105499/empty,Heber Tani,Rumamis,6490000,7282000,10-11-2023,792000
597,1055,https://mpo.psp.pertanian.go.id/v.5.1/pelaporan/105500/empty,Maju Jaya,Rumamis,5605000,6289000,10-11-2023,684000
598,1056,https://mpo.psp.pertanian.go.id/v.5.1/pelaporan/105501/empty,Malemta Ras,Rumamis,4720000,5296000,10-11-2023,576000
599,1057,https://mpo.psp.pertanian.go.id/v.5.1/pelaporan/105503/empty,Super Tani,Rumamis,2950000,3310000,10-11-2023,360000
600,1058,https://mpo.psp.pertanian.go.id/v.5.1/pelaporan/105504/empty,Sadapengejapen,Rumamis,3245000,3641000,10-11-2023,396000
601,1059,https://mpo.psp.pertanian.go.id/v.5.1/pelaporan/105505/empty,Malem Ate,Rumamis,3540000,3972000,10-11-2023,432000
602,1060,https://mpo.psp.pertanian.go.id/v.5.1/pelaporan/105507/empty,Ola Kisat,Rumamis,3245000,3641000,10-11-2023,396000
603,1061,https://mpo.psp.pertanian.go.id/v.5.1/pelaporan/105508/empty,Kita Tani,Rumamis,3835000,4303000,10-11-2023,468000
604,1062,https://mpo.psp.pertanian.go.id/v.5.1/pelaporan/105509/empty,La Tersia,Rumamis,4425000,4965000,10-11-2023,540000
605,1063,https://mpo.psp.pertanian.go.id/v.5.1/pelaporan/105510/empty,Jumata Rimo,Rumamis,5015000,5627000,10-11-2023,612000
606,1064,https://mpo.psp.pertanian.go.id/v.5.1/pelaporan/105512/empty,Palmae,Rumamis,2655000,2979000,10-11-2023,324000
607,1065,https://mpo.psp.pertanian.go.id/v.5.1/pelaporan/105513/empty,Maju Bersama,Rumamis,2950000,3310000,10-11-2023,360000
608,1066,https://mpo.psp.pertanian.go.id/v.5.1/pelaporan/105514/empty,Sangap Encari,Semangat,3540000,3972000,10-11-2023,432000
609,1067,https://mpo.psp.pertanian.go.id/v.5.1/pelaporan/105515/empty,Sangapta Ras,Semangat,4425000,4965000,10-11-2023,540000
610,1068,https://mpo.psp.pertanian.go.id/v.5.1/pelaporan/105516/empty,Enerjik Jeruk,Semangat,3835000,4303000,10-11-2023,468000
611,1069,https://mpo.psp.pertanian.go.id/v.5.1/pelaporan/105518/empty,Juma Jahen,Semangat,4720000,5296000,10-11-2023,576000
612,1070,https://mpo.psp.pertanian.go.id/v.5.1/pelaporan/105519/empty,Mekar Sari,Semangat,5605000,6289000,10-11-2023,684000
613,1071,https://mpo.psp.pertanian.go.id/v.5.1/pelaporan/105520/empty,Juma Julun,Semangat,3835000,4303000,10-11-2023,468000
614,1072,https://mpo.psp.pertanian.go.id/v.5.1/pelaporan/105521/empty,Juma Galuh,Semangat,3540000,3972000,10-11-2023,432000
615,1073,https://mpo.psp.pertanian.go.id/v.5.1/pelaporan/105522/empty,Bunga Ndawa,Semangat,4425000,4965000,10-11-2023,540000
616,1074,https://mpo.psp.pertanian.go.id/v.5.1/pelaporan/105523/empty,Sada Arih,Semangat,5015000,5627000,10-11-2023,612000
617,1075,https://mpo.psp.pertanian.go.id/v.5.1/pelaporan/105525/empty,Hebron,Semangat,3835000,4303000,10-11-2023,468000
618,1076,https://mpo.psp.pertanian.go.id/v.5.1/pelaporan/105527/empty,Arih Ersada,Semangat,3540000,3972000,10-11-2023,432000
619,1077,https://mpo.psp.pertanian.go.id/v.5.1/pelaporan/105528/empty,Ulih Latih,Semangat,3540000,3972000,10-11-2023,432000
620,1078,https://mpo.psp.pertanian.go.id/v.5.1/pelaporan/105529/empty,Meriah Tani,Sikab,2950000,3310000,10-11-2023,360000
621,1079,https://mpo.psp.pertanian.go.id/v.5.1/pelaporan/105530/empty,Makmur Tani,Sikab,2360000,2648000,10-11-2023,288000
622,1080,https://mpo.psp.pertanian.go.id/v.5.1/pelaporan/105531/empty,Palmae Jaya 1,Sukanalu,7375000,8275000,10-11-2023,900000
623,1081,https://mpo.psp.pertanian.go.id/v.5.1/pelaporan/105533/empty,Anugrah,Sukanalu,7080000,7944000,10-11-2023,864000
624,1082,https://mpo.psp.pertanian.go.id/v.5.1/pelaporan/105534/empty,Rumah Mecu 1,Sukanalu,5900000,6620000,10-11-2023,720000
627,1085,https://mpo.psp.pertanian.go.id/v.5.1/pelaporan/105538/empty,Sue Arih,Sukanalu,4425000,4965000,10-11-2023,540000
628,1086,https://mpo.psp.pertanian.go.id/v.5.1/pelaporan/105539/empty,Rumah Ukir,Sukanalu,5900000,6620000,10-11-2023,720000
629,1087,https://mpo.psp.pertanian.go.id/v.5.1/pelaporan/105540/empty,Mamre Mufakat,Sukanalu,8850000,9930000,10-11-2023,1080000
630,1088,https://mpo.psp.pertanian.go.id/v.5.1/pelaporan/105541/empty,Semayang,Sukanalu,6195000,6951000,10-11-2023,756000
631,1089,https://mpo.psp.pertanian.go.id/v.5.1/pelaporan/105542/empty,Penggel Besi II,Sukanalu,4425000,4965000,10-11-2023,540000
632,1090,https://mpo.psp.pertanian.go.id/v.5.1/pelaporan/105543/empty,Juma Mbulagen,Lau Buluh,3540000,3972000,13-11-2023,432000
633,1091,https://mpo.psp.pertanian.go.id/v.5.1/pelaporan/105545/empty,Ronding,Lau Buluh,3540000,3972000,13-11-2023,432000
634,1092,https://mpo.psp.pertanian.go.id/v.5.1/pelaporan/105546/empty,Lau Paku,Lau Buluh,3540000,3972000,13-11-2023,432000
635,1093,https://mpo.psp.pertanian.go.id/v.5.1/pelaporan/105547/empty,Liang Ndahar,Lau Buluh,3540000,3972000,13-11-2023,432000
636,1094,https://mpo.psp.pertanian.go.id/v.5.1/pelaporan/105548/empty,Lau Ngalam,Lau Buluh,3540000,3972000,13-11-2023,432000
637,1095,https://mpo.psp.pertanian.go.id/v.5.1/pelaporan/105549/empty,Lau Moning,Lau Buluh,3540000,3972000,13-11-2023,432000
638,1096,https://mpo.psp.pertanian.go.id/v.5.1/pelaporan/105550/empty,Kenjahe,Lau Buluh,3540000,3972000,13-11-2023,432000
639,1097,https://mpo.psp.pertanian.go.id/v.5.1/pelaporan/105552/empty,Liang Kejaren,Lau Buluh,3540000,3972000,13-11-2023,432000
640,1098,https://mpo.psp.pertanian.go.id/v.5.1/pelaporan/105553/empty,Lau Kesumpat,Lau Buluh,3540000,3972000,13-11-2023,432000
641,1099,https://mpo.psp.pertanian.go.id/v.5.1/pelaporan/105554/empty,Juma Biru,Lau Buluh,3540000,3972000,13-11-2023,432000
642,1100,https://mpo.psp.pertanian.go.id/v.5.1/pelaporan/105555/empty,Buluh Laga,Lau Buluh,3540000,3972000,13-11-2023,432000
643,1101,https://mpo.psp.pertanian.go.id/v.5.1/pelaporan/105556/empty,Deleng,Lau Buluh,3540000,3972000,13-11-2023,432000
644,1102,https://mpo.psp.pertanian.go.id/v.5.1/pelaporan/105557/empty,Kenjulu,Lau Buluh,3540000,3972000,13-11-2023,432000
645,1103,https://mpo.psp.pertanian.go.id/v.5.1/pelaporan/105559/empty,Juma Deher,Mburidi,4130000,4634000,13-11-2023,504000
646,1104,https://mpo.psp.pertanian.go.id/v.5.1/pelaporan/105560/empty,Juma Lau Tamale,Mburidi,3540000,3972000,13-11-2023,432000
647,1105,https://mpo.psp.pertanian.go.id/v.5.1/pelaporan/105561/empty,Juma Mbal-Mbal,Mburidi,4425000,4965000,13-11-2023,540000
648,1106,https://mpo.psp.pertanian.go.id/v.5.1/pelaporan/105562/empty,Juma Ruam,Mburidi,4720000,5296000,13-11-2023,576000
649,1107,https://mpo.psp.pertanian.go.id/v.5.1/pelaporan/105563/empty,Juma Tepas,Mburidi,4130000,4634000,13-11-2023,504000
650,1108,https://mpo.psp.pertanian.go.id/v.5.1/pelaporan/105564/empty,Juma Pengasen,Mburidi,4425000,4965000,13-11-2023,540000
651,1109,https://mpo.psp.pertanian.go.id/v.5.1/pelaporan/105565/empty,Pola Singa,Siabang-abang,2950000,3310000,13-11-2023,360000
652,1110,https://mpo.psp.pertanian.go.id/v.5.1/pelaporan/105567/empty,Juma Lepar,Siabang-abang,2950000,3310000,13-11-2023,360000
653,1111,https://mpo.psp.pertanian.go.id/v.5.1/pelaporan/105568/empty,Buluh Duri,Siabang-abang,2950000,3310000,13-11-2023,360000
654,1112,https://mpo.psp.pertanian.go.id/v.5.1/pelaporan/105569/empty,Tinjo,Siabang-abang,2950000,3310000,13-11-2023,360000
655,1113,https://mpo.psp.pertanian.go.id/v.5.1/pelaporan/105570/empty,Tergayu,Siabang-abang,2950000,3310000,13-11-2023,360000
656,1114,https://mpo.psp.pertanian.go.id/v.5.1/pelaporan/105571/empty,Lau Kerapat,Siabang-abang,2950000,3310000,13-11-2023,360000
657,1115,https://mpo.psp.pertanian.go.id/v.5.1/pelaporan/105572/empty,Lau Gasing,Jinabun,3540000,3972000,13-11-2023,432000
658,1116,https://mpo.psp.pertanian.go.id/v.5.1/pelaporan/105573/empty,Lau Bandar,Jinabun,4425000,4965000,13-11-2023,540000
659,1117,https://mpo.psp.pertanian.go.id/v.5.1/pelaporan/105574/empty,Semborat,Jinabun,3540000,3972000,13-11-2023,432000
660,1118,https://mpo.psp.pertanian.go.id/v.5.1/pelaporan/105576/empty,Embang Perira,Jinabun,4130000,4634000,13-11-2023,504000
661,1119,https://mpo.psp.pertanian.go.id/v.5.1/pelaporan/105577/empty,Pagar Besi,Jinabun,4425000,4965000,13-11-2023,540000
662,1120,https://mpo.psp.pertanian.go.id/v.5.1/pelaporan/105578/empty,Baluren,Jinabun,3540000,3972000,13-11-2023,432000
663,1121,https://mpo.psp.pertanian.go.id/v.5.1/pelaporan/105579/empty,Long-Long,Negeri Jahe,4425000,4965000,13-11-2023,540000
664,1122,https://mpo.psp.pertanian.go.id/v.5.1/pelaporan/105580/empty,Paya Mbentar,Negeri Jahe,4425000,4965000,13-11-2023,540000
666,1124,https://mpo.psp.pertanian.go.id/v.5.1/pelaporan/105582/empty,Urok Pacinta,Negeri Jahe,4425000,4965000,13-11-2023,540000
667,1125,https://mpo.psp.pertanian.go.id/v.5.1/pelaporan/105583/empty,Urok Kambing,Negeri Jahe,4425000,4965000,13-11-2023,540000
668,1126,https://mpo.psp.pertanian.go.id/v.5.1/pelaporan/105585/empty,Rambah Mbelang,Liang Merdeka,4425000,4965000,13-11-2023,540000
669,1127,https://mpo.psp.pertanian.go.id/v.5.1/pelaporan/105586/empty,Belimbingen,Liang Merdeka,4425000,4965000,13-11-2023,540000
670,1128,https://mpo.psp.pertanian.go.id/v.5.1/pelaporan/105587/empty,Tukilen,Liang Merdeka,4425000,4965000,13-11-2023,540000
671,1129,https://mpo.psp.pertanian.go.id/v.5.1/pelaporan/105588/empty,Batu Merdang,Rih Tengah,4425000,4965000,13-11-2023,540000
672,1130,https://mpo.psp.pertanian.go.id/v.5.1/pelaporan/105589/empty,Kepar,Rih Tengah,4425000,4965000,13-11-2023,540000
673,1131,https://mpo.psp.pertanian.go.id/v.5.1/pelaporan/105590/empty,Lau Timah,Rih Tengah,4425000,4965000,13-11-2023,540000
674,1132,https://mpo.psp.pertanian.go.id/v.5.1/pelaporan/105591/empty,Lau Tarutung,Rih Tengah,4425000,4965000,13-11-2023,540000
675,1133,https://mpo.psp.pertanian.go.id/v.5.1/pelaporan/105593/empty,Jagung Satu,Ujung Deleng,3540000,3972000,13-11-2023,432000
676,1134,https://mpo.psp.pertanian.go.id/v.5.1/pelaporan/105594/empty,Jagung Dua,Ujung Deleng,3540000,3972000,13-11-2023,432000
677,1135,https://mpo.psp.pertanian.go.id/v.5.1/pelaporan/105595/empty,Jagung Tiga,Ujung Deleng,3540000,3972000,13-11-2023,432000
678,1136,https://mpo.psp.pertanian.go.id/v.5.1/pelaporan/105596/empty,Jagung Empat,Ujung Deleng,3540000,3972000,13-11-2023,432000
679,1137,https://mpo.psp.pertanian.go.id/v.5.1/pelaporan/105597/empty,Jagung Lima,Ujung Deleng,3540000,3972000,13-11-2023,432000
680,1138,https://mpo.psp.pertanian.go.id/v.5.1/pelaporan/105598/empty,Jagung Enam,Ujung Deleng,3540000,3972000,13-11-2023,432000
681,1139,https://mpo.psp.pertanian.go.id/v.5.1/pelaporan/105600/empty,Jagung Tujuh,Ujung Deleng,3540000,3972000,13-11-2023,432000
682,1140,https://mpo.psp.pertanian.go.id/v.5.1/pelaporan/105601/empty,Jagung Delapan,Ujung Deleng,3540000,3972000,13-11-2023,432000
683,1141,https://mpo.psp.pertanian.go.id/v.5.1/pelaporan/105602/empty,Sangap Encari,Tanjung Merahe,4425000,4965000,13-11-2023,540000
684,1142,https://mpo.psp.pertanian.go.id/v.5.1/pelaporan/105603/empty,Sada Perarih,Tanjung Merahe,4720000,5296000,13-11-2023,576000
685,1143,https://mpo.psp.pertanian.go.id/v.5.1/pelaporan/105604/empty,Arih Ersada,Tanjung Merahe,4130000,4634000,13-11-2023,504000
686,1144,https://mpo.psp.pertanian.go.id/v.5.1/pelaporan/105605/empty,Jaya Ras,Tanjung Merahe,4425000,4965000,13-11-2023,540000
687,1145,https://mpo.psp.pertanian.go.id/v.5.1/pelaporan/105606/empty,Jumpa Rejeki,Tanjung Merahe,5015000,5627000,13-11-2023,612000
688,1146,https://mpo.psp.pertanian.go.id/v.5.1/pelaporan/105607/empty,Juma Diher,Kutabuluh Gugung,7375000,8275000,13-11-2023,900000
689,1147,https://mpo.psp.pertanian.go.id/v.5.1/pelaporan/105609/empty,Juma Kenjahe,Kutabuluh Gugung,7375000,8275000,13-11-2023,900000
690,1148,https://mpo.psp.pertanian.go.id/v.5.1/pelaporan/105610/empty,Juma Genting,Kutabuluh Gugung,7375000,8275000,13-11-2023,900000
691,1149,https://mpo.psp.pertanian.go.id/v.5.1/pelaporan/105611/empty,Juma Deleng,Kutabuluh Gugung,7375000,8275000,13-11-2023,900000
692,1150,https://mpo.psp.pertanian.go.id/v.5.1/pelaporan/105612/empty,Juma Pulo,Kutabuluh Gugung,7375000,8275000,13-11-2023,900000
693,1151,https://mpo.psp.pertanian.go.id/v.5.1/pelaporan/105613/empty,Lepar,Bintang Meriah,2950000,3310000,13-11-2023,360000
694,1152,https://mpo.psp.pertanian.go.id/v.5.1/pelaporan/105614/empty,Simokul-Okul,Bintang Meriah,2950000,3310000,13-11-2023,360000
695,1153,https://mpo.psp.pertanian.go.id/v.5.1/pelaporan/105615/empty,Bulan Gugong,Bintang Meriah,2950000,3310000,13-11-2023,360000
696,1154,https://mpo.psp.pertanian.go.id/v.5.1/pelaporan/105617/empty,Lau Perenden,Bintang Meriah,2950000,3310000,13-11-2023,360000
697,1155,https://mpo.psp.pertanian.go.id/v.5.1/pelaporan/105618/empty,Kendit Kenjahe,Bintang Meriah,2950000,3310000,13-11-2023,360000
698,1156,https://mpo.psp.pertanian.go.id/v.5.1/pelaporan/105619/empty,Lau Batu,Bintang Meriah,2950000,3310000,13-11-2023,360000
699,1157,https://mpo.psp.pertanian.go.id/v.5.1/pelaporan/105620/empty,Nagor,Bintang Meriah,2950000,3310000,13-11-2023,360000
700,1158,https://mpo.psp.pertanian.go.id/v.5.1/pelaporan/105621/empty,Pola Ketik,Bintang Meriah,2950000,3310000,13-11-2023,360000
701,1159,https://mpo.psp.pertanian.go.id/v.5.1/pelaporan/105622/empty,Uruk Ndoholi,Bintang Meriah,2950000,3310000,13-11-2023,360000
702,1160,https://mpo.psp.pertanian.go.id/v.5.1/pelaporan/105623/empty,Uruk Tekang,Bintang Meriah,2950000,3310000,13-11-2023,360000
703,1161,https://mpo.psp.pertanian.go.id/v.5.1/pelaporan/105625/empty,Bagerih,Bintang Meriah,2950000,3310000,13-11-2023,360000
704,1162,https://mpo.psp.pertanian.go.id/v.5.1/pelaporan/105626/empty,Juma Jering,Kutabuluh,2950000,3310000,13-11-2023,360000
705,1163,https://mpo.psp.pertanian.go.id/v.5.1/pelaporan/105627/empty,Sembara Berneh,Kutabuluh,2950000,3310000,13-11-2023,360000
706,1164,https://mpo.psp.pertanian.go.id/v.5.1/pelaporan/105628/empty,Sampaharu,Kutabuluh,2950000,3310000,13-11-2023,360000
707,1165,https://mpo.psp.pertanian.go.id/v.5.1/pelaporan/105629/empty,Rusip,Kutabuluh,2950000,3310000,13-11-2023,360000
708,1166,https://mpo.psp.pertanian.go.id/v.5.1/pelaporan/105630/empty,Kacudan,Kutabuluh,2950000,3310000,13-11-2023,360000
709,1167,https://mpo.psp.pertanian.go.id/v.5.1/pelaporan/105632/empty,Saringgemit,Kutabuluh,2950000,3310000,13-11-2023,360000
710,1168,https://mpo.psp.pertanian.go.id/v.5.1/pelaporan/105633/empty,Pancor Damak,Kutabuluh,2950000,3310000,13-11-2023,360000
711,1169,https://mpo.psp.pertanian.go.id/v.5.1/pelaporan/105634/empty,Juma Tinjo,Kutabuluh,2950000,3310000,13-11-2023,360000
712,1170,https://mpo.psp.pertanian.go.id/v.5.1/pelaporan/105635/empty,Sumbah Lau Beski,Kutabuluh,2950000,3310000,13-11-2023,360000
713,1171,https://mpo.psp.pertanian.go.id/v.5.1/pelaporan/105636/empty,Kedatun,Kutabuluh,2950000,3310000,13-11-2023,360000
714,1172,https://mpo.psp.pertanian.go.id/v.5.1/pelaporan/105637/empty,Lau Pudan,Kutabuluh,2950000,3310000,13-11-2023,360000
715,1173,https://mpo.psp.pertanian.go.id/v.5.1/pelaporan/105639/empty,Kuta Pinang,Kutabuluh,2950000,3310000,13-11-2023,360000
716,1174,https://mpo.psp.pertanian.go.id/v.5.1/pelaporan/105640/empty,Pejerango Lau Ngeli,Kutabuluh,2950000,3310000,13-11-2023,360000
717,1175,https://mpo.psp.pertanian.go.id/v.5.1/pelaporan/105641/empty,Sumbah Gugung,Kutabuluh,2950000,3310000,13-11-2023,360000
718,1176,https://mpo.psp.pertanian.go.id/v.5.1/pelaporan/105642/empty,Nisipi,Kutabuluh,2950000,3310000,13-11-2023,360000
719,1177,https://mpo.psp.pertanian.go.id/v.5.1/pelaporan/105643/empty,Sumbah Berneh,Kutabuluh,2950000,3310000,13-11-2023,360000
720,1178,https://mpo.psp.pertanian.go.id/v.5.1/pelaporan/105644/empty,Sembara Gugung,Kutabuluh,2950000,3310000,13-11-2023,360000
721,1179,https://mpo.psp.pertanian.go.id/v.5.1/pelaporan/105645/empty,Pola Singa,Kutabuluh,2950000,3310000,13-11-2023,360000
722,1180,https://mpo.psp.pertanian.go.id/v.5.1/pelaporan/105647/empty,Uruk Pacinta,Gunung Meriah,4425000,4965000,13-11-2023,540000
723,1181,https://mpo.psp.pertanian.go.id/v.5.1/pelaporan/105648/empty,Urok Tonggal,Gunung Meriah,4425000,4965000,13-11-2023,540000
724,1182,https://mpo.psp.pertanian.go.id/v.5.1/pelaporan/105649/empty,Banjar Mbelang,Gunung Meriah,4425000,4965000,13-11-2023,540000
725,1183,https://mpo.psp.pertanian.go.id/v.5.1/pelaporan/105650/empty,Paya Nderket,Gunung Meriah,4425000,4965000,13-11-2023,540000
726,1184,https://mpo.psp.pertanian.go.id/v.5.1/pelaporan/105651/empty,Juma Deleng,Gunung Meriah,4425000,4965000,13-11-2023,540000
727,1185,https://mpo.psp.pertanian.go.id/v.5.1/pelaporan/105652/empty,Beturah,Buah Raya,3540000,3972000,13-11-2023,432000
728,1186,https://mpo.psp.pertanian.go.id/v.5.1/pelaporan/105653/empty,Kuta Tualah,Buah Raya,3540000,3972000,13-11-2023,432000
729,1187,https://mpo.psp.pertanian.go.id/v.5.1/pelaporan/105655/empty,Sinalsal,Buah Raya,3540000,3972000,13-11-2023,432000
730,1188,https://mpo.psp.pertanian.go.id/v.5.1/pelaporan/105656/empty,Ersam,Buah Raya,3540000,3972000,13-11-2023,432000
731,1189,https://mpo.psp.pertanian.go.id/v.5.1/pelaporan/105657/empty,Simulgap,Buah Raya,3540000,3972000,13-11-2023,432000
732,1190,https://mpo.psp.pertanian.go.id/v.5.1/pelaporan/105658/empty,Rimo Kayu,Buah Raya,3540000,3972000,13-11-2023,432000
733,1191,https://mpo.psp.pertanian.go.id/v.5.1/pelaporan/105659/empty,Lau Gerogoh,Pola Tebu,8850000,9930000,13-11-2023,1080000
734,1192,https://mpo.psp.pertanian.go.id/v.5.1/pelaporan/105660/empty,Pande Bayang,Pola Tebu,8850000,9930000,13-11-2023,1080000
735,1193,https://mpo.psp.pertanian.go.id/v.5.1/pelaporan/105662/empty,Lau Angkat,Pola Tebu,8850000,9930000,13-11-2023,1080000
736,1194,https://mpo.psp.pertanian.go.id/v.5.1/pelaporan/105663/empty,Rumah Kuta,Pola Tebu,8850000,9930000,13-11-2023,1080000
737,1195,https://mpo.psp.pertanian.go.id/v.5.1/pelaporan/105664/empty,Rambah Ingul,Pola Tebu,8850000,9930000,13-11-2023,1080000
739,1197,https://mpo.psp.pertanian.go.id/v.5.1/pelaporan/105666/empty,Juma Baling-baling,Kuta Male,6490000,7282000,13-11-2023,792000
740,1198,https://mpo.psp.pertanian.go.id/v.5.1/pelaporan/105667/empty,Juma Lau Ngalam,Kuta Male,7080000,7944000,13-11-2023,864000
741,1199,https://mpo.psp.pertanian.go.id/v.5.1/pelaporan/105669/empty,Juma Lau Riman,Kuta Male,5900000,6620000,13-11-2023,720000
742,1200,https://mpo.psp.pertanian.go.id/v.5.1/pelaporan/105670/empty,Juma Paya Gugung,Kuta Male,5900000,6620000,13-11-2023,720000
743,1201,https://mpo.psp.pertanian.go.id/v.5.1/pelaporan/105671/empty,Lau Butar,Kuta Male,5900000,6620000,13-11-2023,720000
744,1202,https://mpo.psp.pertanian.go.id/v.5.1/pelaporan/105672/empty,Pacike,Kuta Male,5900000,6620000,13-11-2023,720000
745,1203,https://mpo.psp.pertanian.go.id/v.5.1/pelaporan/105673/empty,Jumpa Rejeki,Suka,5900000,6620000,10-11-2023,720000
746,1204,https://mpo.psp.pertanian.go.id/v.5.1/pelaporan/105674/empty,Paya Paku,Suka,5900000,6620000,10-11-2023,720000
747,1205,https://mpo.psp.pertanian.go.id/v.5.1/pelaporan/105676/empty,Rumah Pengulun,Suka,5900000,6620000,10-11-2023,720000
748,1206,https://mpo.psp.pertanian.go.id/v.5.1/pelaporan/105677/empty,Sangap Encari,Suka,5900000,6620000,10-11-2023,720000
749,1207,https://mpo.psp.pertanian.go.id/v.5.1/pelaporan/105678/empty,Bina Usaha,Suka,5900000,6620000,10-11-2023,720000
750,1208,https://mpo.psp.pertanian.go.id/v.5.1/pelaporan/105679/empty,Tunas Jadi Batang,Suka,5900000,6620000,10-11-2023,720000
751,1209,https://mpo.psp.pertanian.go.id/v.5.1/pelaporan/105680/empty,Andiko Ulina,Suka,5900000,6620000,10-11-2023,720000
752,1210,https://mpo.psp.pertanian.go.id/v.5.1/pelaporan/105681/empty,Ajar Bancina,Suka,5900000,6620000,10-11-2023,720000
753,1211,https://mpo.psp.pertanian.go.id/v.5.1/pelaporan/105683/empty,Rudang Mayang,Suka,5900000,6620000,10-11-2023,720000
754,1212,https://mpo.psp.pertanian.go.id/v.5.1/pelaporan/105684/empty,Harapan Jaya,Suka,5900000,6620000,10-11-2023,720000
755,1213,https://mpo.psp.pertanian.go.id/v.5.1/pelaporan/105685/empty,Aglonema,Suka,5900000,6620000,10-11-2023,720000
756,1214,https://mpo.psp.pertanian.go.id/v.5.1/pelaporan/105686/empty,Bunga Jadi Buah,Suka,5900000,6620000,10-11-2023,720000
757,1215,https://mpo.psp.pertanian.go.id/v.5.1/pelaporan/105687/empty,Seh Jilena,Suka,5900000,6620000,10-11-2023,720000
758,1216,https://mpo.psp.pertanian.go.id/v.5.1/pelaporan/105688/empty,Maju Bersama,Suka Mbayak,5900000,6620000,10-11-2023,720000
759,1217,https://mpo.psp.pertanian.go.id/v.5.1/pelaporan/105690/empty,Mandiri Sejahtera,Suka Mbayak,5900000,6620000,10-11-2023,720000
760,1218,https://mpo.psp.pertanian.go.id/v.5.1/pelaporan/105691/empty,Rumah Pilihen Simalem,Suka Mbayak,5900000,6620000,10-11-2023,720000
761,1219,https://mpo.psp.pertanian.go.id/v.5.1/pelaporan/105692/empty,Maju Bersama Abadi,Suka Mbayak,5900000,6620000,10-11-2023,720000
762,1220,https://mpo.psp.pertanian.go.id/v.5.1/pelaporan/105693/empty,Ersinalsal,Suka Mbayak,5900000,6620000,10-11-2023,720000
763,1221,https://mpo.psp.pertanian.go.id/v.5.1/pelaporan/105694/empty,Sinergi Fajar Harapan,Suka Mbayak,5900000,6620000,10-11-2023,720000
764,1222,https://mpo.psp.pertanian.go.id/v.5.1/pelaporan/105695/empty,Lit Malemna,Suka Mbayak,5900000,6620000,10-11-2023,720000
765,1223,https://mpo.psp.pertanian.go.id/v.5.1/pelaporan/105696/empty,Srikandi,Suka Mbayak,5900000,6620000,10-11-2023,720000
766,1224,https://mpo.psp.pertanian.go.id/v.5.1/pelaporan/105697/empty,Maju Bersama Sejati,Suka Mbayak,5900000,6620000,10-11-2023,720000
767,1225,https://mpo.psp.pertanian.go.id/v.5.1/pelaporan/105699/empty,Juma Sempulen Angin,Suka Sipilihen,5900000,6620000,10-11-2023,720000
768,1226,https://mpo.psp.pertanian.go.id/v.5.1/pelaporan/105700/empty,Karya Bersama,Suka Sipilihen,6490000,7282000,10-11-2023,792000
769,1227,https://mpo.psp.pertanian.go.id/v.5.1/pelaporan/105701/empty,Silindung Bulan Jabu Nderket,Suka Sipilihen,5900000,6620000,10-11-2023,720000
770,1228,https://mpo.psp.pertanian.go.id/v.5.1/pelaporan/105702/empty,Simulih Karaben,Suka Sipilihen,5900000,6620000,10-11-2023,720000
771,1229,https://mpo.psp.pertanian.go.id/v.5.1/pelaporan/105703/empty,Bina Tani,Suka Sipilihen,5900000,6620000,10-11-2023,720000
772,1230,https://mpo.psp.pertanian.go.id/v.5.1/pelaporan/105704/empty,Mbuah Page,Suka Sipilihen,5900000,6620000,10-11-2023,720000
773,1231,https://mpo.psp.pertanian.go.id/v.5.1/pelaporan/105705/empty,Mawar,Lambar,4425000,4965000,10-11-2023,540000
774,1232,https://mpo.psp.pertanian.go.id/v.5.1/pelaporan/105707/empty,Melati,Lambar,4425000,4965000,10-11-2023,540000
775,1233,https://mpo.psp.pertanian.go.id/v.5.1/pelaporan/105708/empty,Juma Luning,Bunuraya,5900000,6620000,10-11-2023,720000
776,1234,https://mpo.psp.pertanian.go.id/v.5.1/pelaporan/105709/empty,Sepopo,Bunuraya,5900000,6620000,10-11-2023,720000
777,1235,https://mpo.psp.pertanian.go.id/v.5.1/pelaporan/105710/empty,Radu Namaken Kekelengen,Bunuraya,5900000,6620000,10-11-2023,720000
778,1236,https://mpo.psp.pertanian.go.id/v.5.1/pelaporan/105711/empty,Arih Ersada,Bunuraya,5900000,6620000,10-11-2023,720000
779,1237,https://mpo.psp.pertanian.go.id/v.5.1/pelaporan/105712/empty,Juma Kenjahe,Bunuraya,5900000,6620000,10-11-2023,720000
780,1238,https://mpo.psp.pertanian.go.id/v.5.1/pelaporan/105713/empty,Maju Bersama,Bunuraya,5900000,6620000,10-11-2023,720000
781,1239,https://mpo.psp.pertanian.go.id/v.5.1/pelaporan/105714/empty,Sada Perarih,Bunuraya,5900000,6620000,10-11-2023,720000
782,1240,https://mpo.psp.pertanian.go.id/v.5.1/pelaporan/105715/empty,Goxen,Bunuraya,5900000,6620000,10-11-2023,720000
783,1241,https://mpo.psp.pertanian.go.id/v.5.1/pelaporan/105716/empty,Em'Praninta,Bunuraya,5900000,6620000,10-11-2023,720000
784,1242,https://mpo.psp.pertanian.go.id/v.5.1/pelaporan/105717/empty,Mejuah-juah,Bunuraya,5900000,6620000,10-11-2023,720000
785,1243,https://mpo.psp.pertanian.go.id/v.5.1/pelaporan/105718/empty,Sempakata,Bunuraya,5900000,6620000,10-11-2023,720000
786,1244,https://mpo.psp.pertanian.go.id/v.5.1/pelaporan/105719/empty,Rumah Rih,Bunuraya,5900000,6620000,10-11-2023,720000
787,1245,https://mpo.psp.pertanian.go.id/v.5.1/pelaporan/105720/empty,Sierduhum,Bunuraya,5900000,6620000,10-11-2023,720000
788,1246,https://mpo.psp.pertanian.go.id/v.5.1/pelaporan/105721/empty,Sada Nioga,Bunuraya,5900000,6620000,10-11-2023,720000
789,1247,https://mpo.psp.pertanian.go.id/v.5.1/pelaporan/105722/empty,Sumber Jaya,Mulawari,2950000,3310000,10-11-2023,360000
790,1248,https://mpo.psp.pertanian.go.id/v.5.1/pelaporan/105723/empty,Gotong Royong,Mulawari,2950000,3310000,10-11-2023,360000
791,1249,https://mpo.psp.pertanian.go.id/v.5.1/pelaporan/105724/empty,Ula Rayung,Mulawari,2950000,3310000,10-11-2023,360000
792,1250,https://mpo.psp.pertanian.go.id/v.5.1/pelaporan/105725/empty,Maju Bersama,Mulawari,2950000,3310000,10-11-2023,360000
793,1251,https://mpo.psp.pertanian.go.id/v.5.1/pelaporan/105726/empty,Mitra Karya Bersama,Mulawari,2950000,3310000,10-11-2023,360000
794,1252,https://mpo.psp.pertanian.go.id/v.5.1/pelaporan/105727/empty,Erguna,Mulawari,2950000,3310000,10-11-2023,360000
795,1253,https://mpo.psp.pertanian.go.id/v.5.1/pelaporan/105728/empty,Arih Ersada,Tigapanah,2950000,3310000,10-11-2023,360000
796,1254,https://mpo.psp.pertanian.go.id/v.5.1/pelaporan/105730/empty,Harapan Jaya,Tigapanah,2950000,3310000,10-11-2023,360000
797,1255,https://mpo.psp.pertanian.go.id/v.5.1/pelaporan/105731/empty,Sempakata,Tigapanah,2950000,3310000,10-11-2023,360000
798,1256,https://mpo.psp.pertanian.go.id/v.5.1/pelaporan/105732/empty,Dame Tani,Tigapanah,2950000,3310000,10-11-2023,360000
799,1257,https://mpo.psp.pertanian.go.id/v.5.1/pelaporan/105733/empty,Harapan Tani,Tigapanah,2950000,3310000,10-11-2023,360000
800,1258,https://mpo.psp.pertanian.go.id/v.5.1/pelaporan/105734/empty,Kata Ersada,Tigapanah,2950000,3310000,10-11-2023,360000
801,1259,https://mpo.psp.pertanian.go.id/v.5.1/pelaporan/105735/empty,Rejekinta,Tigapanah,2950000,3310000,10-11-2023,360000
802,1260,https://mpo.psp.pertanian.go.id/v.5.1/pelaporan/105736/empty,Jore Tani,Tigapanah,2950000,3310000,10-11-2023,360000
803,1261,https://mpo.psp.pertanian.go.id/v.5.1/pelaporan/105738/empty,Hidup Baru,Tigapanah,2950000,3310000,10-11-2023,360000
804,1262,https://mpo.psp.pertanian.go.id/v.5.1/pelaporan/105739/empty,Sepenggejapen,Tigapanah,2950000,3310000,10-11-2023,360000
805,1263,https://mpo.psp.pertanian.go.id/v.5.1/pelaporan/105740/empty,Juma Baris II,Leparsamura,4425000,4965000,10-11-2023,540000
806,1264,https://mpo.psp.pertanian.go.id/v.5.1/pelaporan/105741/empty,Juma Serningen,Leparsamura,4425000,4965000,10-11-2023,540000
807,1265,https://mpo.psp.pertanian.go.id/v.5.1/pelaporan/105742/empty,Juma Gerat,Leparsamura,4425000,4965000,10-11-2023,540000
808,1266,https://mpo.psp.pertanian.go.id/v.5.1/pelaporan/105743/empty,Juma Tumande,Leparsamura,4425000,4965000,10-11-2023,540000
809,1267,https://mpo.psp.pertanian.go.id/v.5.1/pelaporan/105745/empty,Dalan Lau Simomo,Singa,4425000,4965000,10-11-2023,540000
810,1268,https://mpo.psp.pertanian.go.id/v.5.1/pelaporan/105746/empty,Singa Jaya,Singa,4425000,4965000,10-11-2023,540000
811,1269,https://mpo.psp.pertanian.go.id/v.5.1/pelaporan/105747/empty,Guna Tani,Singa,4425000,4965000,10-11-2023,540000
812,1270,https://mpo.psp.pertanian.go.id/v.5.1/pelaporan/105748/empty,Arih Ersada,Singa,4425000,4965000,10-11-2023,540000
813,1271,https://mpo.psp.pertanian.go.id/v.5.1/pelaporan/105749/empty,Beras Pati,Singa,4425000,4965000,10-11-2023,540000
814,1272,https://mpo.psp.pertanian.go.id/v.5.1/pelaporan/105750/empty,Biak Kuliki,Singa,4425000,4965000,10-11-2023,540000
815,1273,https://mpo.psp.pertanian.go.id/v.5.1/pelaporan/105751/empty,WT Gunanta Ras,Singa,4425000,4965000,10-11-2023,540000
816,1274,https://mpo.psp.pertanian.go.id/v.5.1/pelaporan/105753/empty,Lau Piga,Singa,4425000,4965000,10-11-2023,540000
817,1275,https://mpo.psp.pertanian.go.id/v.5.1/pelaporan/105754/empty,Marsima,Singa,4425000,4965000,10-11-2023,540000
818,1276,https://mpo.psp.pertanian.go.id/v.5.1/pelaporan/105755/empty,Juma Kenjahe,Singa,4425000,4965000,10-11-2023,540000
819,1277,https://mpo.psp.pertanian.go.id/v.5.1/pelaporan/105756/empty,Wanita Tani,Salit,6490000,7282000,10-11-2023,792000
820,1278,https://mpo.psp.pertanian.go.id/v.5.1/pelaporan/105757/empty,Sangap Encari,Salit,5900000,6620000,10-11-2023,720000
821,1279,https://mpo.psp.pertanian.go.id/v.5.1/pelaporan/105758/empty,Pelangi,Salit,7080000,7944000,10-11-2023,864000
822,1280,https://mpo.psp.pertanian.go.id/v.5.1/pelaporan/105760/empty,Arih Ersada,Salit,6490000,7282000,10-11-2023,792000
823,1281,https://mpo.psp.pertanian.go.id/v.5.1/pelaporan/105761/empty,Merga Silima,Salit,6785000,7613000,10-11-2023,828000
824,1282,https://mpo.psp.pertanian.go.id/v.5.1/pelaporan/105762/empty,Ora Et Labora,Salit,6195000,6951000,10-11-2023,756000
825,1283,https://mpo.psp.pertanian.go.id/v.5.1/pelaporan/105763/empty,Mari Ras Seha,Salit,6490000,7282000,10-11-2023,792000
826,1284,https://mpo.psp.pertanian.go.id/v.5.1/pelaporan/105764/empty,Juma Salit,Salit,7375000,8275000,10-11-2023,900000
827,1285,https://mpo.psp.pertanian.go.id/v.5.1/pelaporan/105765/empty,Sada Arihta,Sukadame,4425000,4965000,10-11-2023,540000
828,1286,https://mpo.psp.pertanian.go.id/v.5.1/pelaporan/105767/empty,Srikandi,Sukadame,4425000,4965000,10-11-2023,540000
829,1287,https://mpo.psp.pertanian.go.id/v.5.1/pelaporan/105768/empty,Buah Meramis,Sukadame,4425000,4965000,10-11-2023,540000
830,1288,https://mpo.psp.pertanian.go.id/v.5.1/pelaporan/105769/empty,Sada Nioga,Sukadame,4425000,4965000,10-11-2023,540000
831,1289,https://mpo.psp.pertanian.go.id/v.5.1/pelaporan/105770/empty,Teman Meriah,Sukadame,4425000,4965000,10-11-2023,540000
832,1290,https://mpo.psp.pertanian.go.id/v.5.1/pelaporan/105771/empty,Bunga Encole,Sukadame,4425000,4965000,10-11-2023,540000
833,1291,https://mpo.psp.pertanian.go.id/v.5.1/pelaporan/105772/empty,Lau Ngelbuh,Kutambelin,4425000,4965000,10-11-2023,540000
834,1292,https://mpo.psp.pertanian.go.id/v.5.1/pelaporan/105774/empty,Biak Kuliki,Kutambelin,4425000,4965000,10-11-2023,540000
836,1294,https://mpo.psp.pertanian.go.id/v.5.1/pelaporan/105776/empty,Juma Kenjahe,Kutambelin,4425000,4965000,10-11-2023,540000
837,1295,https://mpo.psp.pertanian.go.id/v.5.1/pelaporan/105777/empty,Sendalanen,Kutambelin,4425000,4965000,10-11-2023,540000
838,1296,https://mpo.psp.pertanian.go.id/v.5.1/pelaporan/105778/empty,Tambusen,Kutambelin,4425000,4965000,10-11-2023,540000
839,1297,https://mpo.psp.pertanian.go.id/v.5.1/pelaporan/105779/empty,Ujung Suka,Kutambelin,4425000,4965000,10-11-2023,540000
840,1298,https://mpo.psp.pertanian.go.id/v.5.1/pelaporan/105780/empty,Juma Paya,Kutambelin,4425000,4965000,10-11-2023,540000
841,1299,https://mpo.psp.pertanian.go.id/v.5.1/pelaporan/105781/empty,Arih Ersada,Perbaji,4425000,4965000,13-11-2023,540000
842,1300,https://mpo.psp.pertanian.go.id/v.5.1/pelaporan/105782/empty,Ulih Sabar,Perbaji,4425000,4965000,13-11-2023,540000
843,1301,https://mpo.psp.pertanian.go.id/v.5.1/pelaporan/105783/empty,Sabah Berneh,Perbaji,4425000,4965000,13-11-2023,540000
844,1302,https://mpo.psp.pertanian.go.id/v.5.1/pelaporan/105784/empty,Ulih Latih,Perbaji,4425000,4965000,13-11-2023,540000
845,1303,https://mpo.psp.pertanian.go.id/v.5.1/pelaporan/105786/empty,Terpadu,Perbaji,4425000,4965000,13-11-2023,540000
846,1304,https://mpo.psp.pertanian.go.id/v.5.1/pelaporan/105787/empty,Gunanta Ras,Perbaji,4425000,4965000,13-11-2023,540000
847,1305,https://mpo.psp.pertanian.go.id/v.5.1/pelaporan/105788/empty,Juma Gugung,Perbaji,4425000,4965000,13-11-2023,540000
848,1306,https://mpo.psp.pertanian.go.id/v.5.1/pelaporan/105789/empty,Juma Tualah,Sukatendel,4425000,4965000,13-11-2023,540000
849,1307,https://mpo.psp.pertanian.go.id/v.5.1/pelaporan/105790/empty,Juma Bekerah,Sukatendel,4425000,4965000,13-11-2023,540000
850,1308,https://mpo.psp.pertanian.go.id/v.5.1/pelaporan/105791/empty,Taka Empat,Sukatendel,4425000,4965000,13-11-2023,540000
851,1309,https://mpo.psp.pertanian.go.id/v.5.1/pelaporan/105792/empty,Ola Kisat,Sukatendel,4425000,4965000,13-11-2023,540000
852,1310,https://mpo.psp.pertanian.go.id/v.5.1/pelaporan/105794/empty,Juma Saburak,Sukatendel,4425000,4965000,13-11-2023,540000
853,1311,https://mpo.psp.pertanian.go.id/v.5.1/pelaporan/105795/empty,Erkaliaga,Sukatendel,4425000,4965000,13-11-2023,540000
854,1312,https://mpo.psp.pertanian.go.id/v.5.1/pelaporan/105796/empty,Pandaken,Sukatendel,4425000,4965000,13-11-2023,540000
856,1314,https://mpo.psp.pertanian.go.id/v.5.1/pelaporan/105798/empty,Lau Bentayan,Sukatendel,4425000,4965000,13-11-2023,540000
857,1315,https://mpo.psp.pertanian.go.id/v.5.1/pelaporan/105799/empty,Jalontih,Sukatendel,4425000,4965000,13-11-2023,540000
858,1316,https://mpo.psp.pertanian.go.id/v.5.1/pelaporan/105801/empty,Arih Ersada,Sukatendel,4425000,4965000,13-11-2023,540000
859,1317,https://mpo.psp.pertanian.go.id/v.5.1/pelaporan/105802/empty,Sikuning - Kuningan,Sukatendel,4425000,4965000,13-11-2023,540000
860,1318,https://mpo.psp.pertanian.go.id/v.5.1/pelaporan/105803/empty,Juma Kenjahe I,Jandimeriah,4425000,4965000,13-11-2023,540000
861,1319,https://mpo.psp.pertanian.go.id/v.5.1/pelaporan/105804/empty,Juma Gerat Mbergo,Jandimeriah,4425000,4965000,13-11-2023,540000
862,1320,https://mpo.psp.pertanian.go.id/v.5.1/pelaporan/105805/empty,Juma Buah,Jandimeriah,4425000,4965000,13-11-2023,540000
863,1321,https://mpo.psp.pertanian.go.id/v.5.1/pelaporan/105807/empty,Juma Bangun Mulia II,Jandimeriah,4425000,4965000,13-11-2023,540000
864,1322,https://mpo.psp.pertanian.go.id/v.5.1/pelaporan/105808/empty,Juma Cingkam,Jandimeriah,4425000,4965000,13-11-2023,540000
865,1323,https://mpo.psp.pertanian.go.id/v.5.1/pelaporan/105809/empty,Juma Kenjahe III,Jandimeriah,4425000,4965000,13-11-2023,540000
866,1324,https://mpo.psp.pertanian.go.id/v.5.1/pelaporan/105810/empty,Juma Kenjahe II,Jandimeriah,4425000,4965000,13-11-2023,540000
867,1325,https://mpo.psp.pertanian.go.id/v.5.1/pelaporan/105811/empty,Juma Mbetong,Jandimeriah,4425000,4965000,13-11-2023,540000
868,1326,https://mpo.psp.pertanian.go.id/v.5.1/pelaporan/105812/empty,Bangun Mulia I,Jandimeriah,4425000,4965000,13-11-2023,540000
869,1327,https://mpo.psp.pertanian.go.id/v.5.1/pelaporan/105814/empty,Juma Kenjahe IV,Jandimeriah,4425000,4965000,13-11-2023,540000
870,1328,https://mpo.psp.pertanian.go.id/v.5.1/pelaporan/105815/empty,Terong Peren I,Jandimeriah,4425000,4965000,13-11-2023,540000
871,1329,https://mpo.psp.pertanian.go.id/v.5.1/pelaporan/105816/empty,Terong Peren II,Jandimeriah,4425000,4965000,13-11-2023,540000
872,1330,https://mpo.psp.pertanian.go.id/v.5.1/pelaporan/105817/empty,Bangun Mulia III,Jandimeriah,4425000,4965000,13-11-2023,540000
873,1331,https://mpo.psp.pertanian.go.id/v.5.1/pelaporan/105818/empty,Sapolentik,Tiganderket,2950000,3310000,13-11-2023,360000
874,1332,https://mpo.psp.pertanian.go.id/v.5.1/pelaporan/105819/empty,Lau Mangkok,Tiganderket,2950000,3310000,13-11-2023,360000
875,1333,https://mpo.psp.pertanian.go.id/v.5.1/pelaporan/105821/empty,Juma Mbelang,Tiganderket,2950000,3310000,13-11-2023,360000
876,1334,https://mpo.psp.pertanian.go.id/v.5.1/pelaporan/105822/empty,Juma Kepoh,Tiganderket,2950000,3310000,13-11-2023,360000
877,1335,https://mpo.psp.pertanian.go.id/v.5.1/pelaporan/105823/empty,Lau Tambak Saribu,Tiganderket,2950000,3310000,13-11-2023,360000
878,1336,https://mpo.psp.pertanian.go.id/v.5.1/pelaporan/105824/empty,Juma Ciger,Tiganderket,2950000,3310000,13-11-2023,360000
879,1337,https://mpo.psp.pertanian.go.id/v.5.1/pelaporan/105825/empty,Juma Nangka,Tiganderket,2950000,3310000,13-11-2023,360000
880,1338,https://mpo.psp.pertanian.go.id/v.5.1/pelaporan/105827/empty,Buah Periran,Tiganderket,2950000,3310000,13-11-2023,360000
881,1339,https://mpo.psp.pertanian.go.id/v.5.1/pelaporan/105828/empty,Lau Banban,Tiganderket,2950000,3310000,13-11-2023,360000
882,1340,https://mpo.psp.pertanian.go.id/v.5.1/pelaporan/105829/empty,Juma Kenjulu,Tiganderket,2950000,3310000,13-11-2023,360000
883,1341,https://mpo.psp.pertanian.go.id/v.5.1/pelaporan/105830/empty,Juma Semebok,Tiganderket,2950000,3310000,13-11-2023,360000
884,1342,https://mpo.psp.pertanian.go.id/v.5.1/pelaporan/105831/empty,Lau Tengguli,Tiganderket,2950000,3310000,13-11-2023,360000
885,1343,https://mpo.psp.pertanian.go.id/v.5.1/pelaporan/105833/empty,Lau Jering,Narigunung I,7375000,8275000,13-11-2023,900000
886,1344,https://mpo.psp.pertanian.go.id/v.5.1/pelaporan/105834/empty,Juma Pasar,Narigunung I,7080000,7944000,13-11-2023,864000
887,1345,https://mpo.psp.pertanian.go.id/v.5.1/pelaporan/105835/empty,Dalan Tengah,Narigunung I,7670000,8606000,13-11-2023,936000
888,1346,https://mpo.psp.pertanian.go.id/v.5.1/pelaporan/105836/empty,Lau Kormak,Narigunung I,8260000,9268000,13-11-2023,1008000
889,1347,https://mpo.psp.pertanian.go.id/v.5.1/pelaporan/105837/empty,Durin Sirulo,Narigunung I,8260000,9268000,13-11-2023,1008000
890,1348,https://mpo.psp.pertanian.go.id/v.5.1/pelaporan/105839/empty,Uruk Pelangkah,Narigunung I,7080000,7944000,13-11-2023,864000
891,1349,https://mpo.psp.pertanian.go.id/v.5.1/pelaporan/105840/empty,Tanji Gugung,Penampen,3835000,4303000,13-11-2023,468000
892,1350,https://mpo.psp.pertanian.go.id/v.5.1/pelaporan/105841/empty,Uruk Meganjang,Penampen,3835000,4303000,13-11-2023,468000
893,1351,https://mpo.psp.pertanian.go.id/v.5.1/pelaporan/105842/empty,Lau Jering,Penampen,3835000,4303000,13-11-2023,468000
894,1352,https://mpo.psp.pertanian.go.id/v.5.1/pelaporan/105843/empty,Uruk Berteng,Penampen,3835000,4303000,13-11-2023,468000
895,1353,https://mpo.psp.pertanian.go.id/v.5.1/pelaporan/105845/empty,Juma Kenjulu,Penampen,3835000,4303000,13-11-2023,468000
896,1354,https://mpo.psp.pertanian.go.id/v.5.1/pelaporan/105846/empty,Sari Lumut,Penampen,3835000,4303000,13-11-2023,468000
897,1355,https://mpo.psp.pertanian.go.id/v.5.1/pelaporan/105847/empty,Uruk Gedang,Penampen,3835000,4303000,13-11-2023,468000
898,1356,https://mpo.psp.pertanian.go.id/v.5.1/pelaporan/105848/empty,Romance,Penampen,3835000,4303000,13-11-2023,468000
899,1357,https://mpo.psp.pertanian.go.id/v.5.1/pelaporan/105849/empty,Ola Kisat,Gunung Merlawan,5015000,5627000,13-11-2023,612000
900,1358,https://mpo.psp.pertanian.go.id/v.5.1/pelaporan/105851/empty,Arih Ersada,Gunung Merlawan,5015000,5627000,13-11-2023,612000
901,1359,https://mpo.psp.pertanian.go.id/v.5.1/pelaporan/105852/empty,Eka Deba,Gunung Merlawan,5015000,5627000,13-11-2023,612000
902,1360,https://mpo.psp.pertanian.go.id/v.5.1/pelaporan/105853/empty,Juma Uruk Mbelin,Kutakepar,5605000,6289000,13-11-2023,684000
903,1361,https://mpo.psp.pertanian.go.id/v.5.1/pelaporan/105854/empty,Juma Pusong-Pusong,Kutakepar,5605000,6289000,13-11-2023,684000
904,1362,https://mpo.psp.pertanian.go.id/v.5.1/pelaporan/105855/empty,Juma Urok,Kutagaluh,3540000,3972000,13-11-2023,432000
906,1364,https://mpo.psp.pertanian.go.id/v.5.1/pelaporan/105858/empty,Juma Suka Ribu,Kutagaluh,2950000,3310000,13-11-2023,360000
907,1365,https://mpo.psp.pertanian.go.id/v.5.1/pelaporan/105859/empty,Juma Tambak,Kutagaluh,2950000,3310000,13-11-2023,360000
908,1366,https://mpo.psp.pertanian.go.id/v.5.1/pelaporan/105860/empty,Juma Ciger,Kutagaluh,2950000,3310000,13-11-2023,360000
909,1367,https://mpo.psp.pertanian.go.id/v.5.1/pelaporan/105861/empty,Juma Lepar,Kutagaluh,2950000,3310000,13-11-2023,360000
910,1368,https://mpo.psp.pertanian.go.id/v.5.1/pelaporan/105862/empty,Juma Kenjulu,Kutagaluh,3540000,3972000,13-11-2023,432000
911,1369,https://mpo.psp.pertanian.go.id/v.5.1/pelaporan/105863/empty,Lau Dalih Simalem,Kutagaluh,3540000,3972000,13-11-2023,432000
912,1370,https://mpo.psp.pertanian.go.id/v.5.1/pelaporan/105864/empty,Juma Sempinor,Kutagaluh,2950000,3310000,13-11-2023,360000
913,1371,https://mpo.psp.pertanian.go.id/v.5.1/pelaporan/105865/empty,Juma Baluren Gedang,Kutagaluh,2950000,3310000,13-11-2023,360000
914,1372,https://mpo.psp.pertanian.go.id/v.5.1/pelaporan/105867/empty,Juma Rakit,Kutagaluh,3245000,3641000,13-11-2023,396000
915,1373,https://mpo.psp.pertanian.go.id/v.5.1/pelaporan/105868/empty,Juma Lau Paya,Temburun,4425000,4965000,13-11-2023,540000
918,1376,https://mpo.psp.pertanian.go.id/v.5.1/pelaporan/105871/empty,Juma Njulu,Temburun,4425000,4965000,13-11-2023,540000
921,1379,https://mpo.psp.pertanian.go.id/v.5.1/pelaporan/105875/empty,Juma Baluren,Susuk,2950000,3310000,13-11-2023,360000
922,1380,https://mpo.psp.pertanian.go.id/v.5.1/pelaporan/105876/empty,Juma Batu,Susuk,2360000,2648000,13-11-2023,288000
923,1381,https://mpo.psp.pertanian.go.id/v.5.1/pelaporan/105877/empty,Juma Tangga,Susuk,2950000,3310000,13-11-2023,360000
924,1382,https://mpo.psp.pertanian.go.id/v.5.1/pelaporan/105878/empty,Singkut Nihan,Susuk,4425000,4965000,13-11-2023,540000
925,1383,https://mpo.psp.pertanian.go.id/v.5.1/pelaporan/105880/empty,Deleng Susuk,Susuk,2950000,3310000,13-11-2023,360000
926,1384,https://mpo.psp.pertanian.go.id/v.5.1/pelaporan/105881/empty,Juma Garut,Susuk,4425000,4965000,13-11-2023,540000
927,1385,https://mpo.psp.pertanian.go.id/v.5.1/pelaporan/105882/empty,Juma Tampe,Susuk,2655000,2979000,13-11-2023,324000
928,1386,https://mpo.psp.pertanian.go.id/v.5.1/pelaporan/105883/empty,Rambah Tampu,Susuk,2655000,2979000,13-11-2023,324000
929,1387,https://mpo.psp.pertanian.go.id/v.5.1/pelaporan/105884/empty,Juma Sekendit,Susuk,2655000,2979000,13-11-2023,324000
930,1388,https://mpo.psp.pertanian.go.id/v.5.1/pelaporan/105885/empty,Juma Bencirum,Susuk,2950000,3310000,13-11-2023,360000
931,1389,https://mpo.psp.pertanian.go.id/v.5.1/pelaporan/105886/empty,Telong Ketik,Susuk,4425000,4965000,13-11-2023,540000
932,1390,https://mpo.psp.pertanian.go.id/v.5.1/pelaporan/105888/empty,Juma Biru,Susuk,2065000,2317000,13-11-2023,252000
933,1391,https://mpo.psp.pertanian.go.id/v.5.1/pelaporan/105889/empty,Pola Cimbang,Kutambaru,4425000,4965000,13-11-2023,540000
934,1392,https://mpo.psp.pertanian.go.id/v.5.1/pelaporan/105890/empty,Jalungga,Kutambaru,4425000,4965000,13-11-2023,540000
935,1393,https://mpo.psp.pertanian.go.id/v.5.1/pelaporan/105891/empty,Burun Tua,Kutambaru,4425000,4965000,13-11-2023,540000
936,1394,https://mpo.psp.pertanian.go.id/v.5.1/pelaporan/105892/empty,Batu Keliat,Kutambaru,4425000,4965000,13-11-2023,540000
937,1395,https://mpo.psp.pertanian.go.id/v.5.1/pelaporan/105893/empty,Lige - Lige,Kutambaru,4425000,4965000,13-11-2023,540000
938,1396,https://mpo.psp.pertanian.go.id/v.5.1/pelaporan/105894/empty,Jaya Lestari,Kutambaru,4425000,4965000,13-11-2023,540000
939,1397,https://mpo.psp.pertanian.go.id/v.5.1/pelaporan/105896/empty,Sireme,Kutambaru,4425000,4965000,13-11-2023,540000
941,1399,https://mpo.psp.pertanian.go.id/v.5.1/pelaporan/105898/empty,Juma Tagan Telu,Mardingding,2950000,3310000,13-11-2023,360000
942,1400,https://mpo.psp.pertanian.go.id/v.5.1/pelaporan/105899/empty,Juma Mbergang,Mardingding,2950000,3310000,13-11-2023,360000
943,1401,https://mpo.psp.pertanian.go.id/v.5.1/pelaporan/105900/empty,Juma Selendi,Mardingding,2950000,3310000,13-11-2023,360000
944,1402,https://mpo.psp.pertanian.go.id/v.5.1/pelaporan/105901/empty,Juma Pulo,Mardingding,2950000,3310000,13-11-2023,360000
945,1403,https://mpo.psp.pertanian.go.id/v.5.1/pelaporan/105903/empty,Tanah  Gara,Mardingding,2950000,3310000,13-11-2023,360000
946,1404,https://mpo.psp.pertanian.go.id/v.5.1/pelaporan/105904/empty,Juma Bakerah Mbelin,Mardingding,2950000,3310000,13-11-2023,360000
947,1405,https://mpo.psp.pertanian.go.id/v.5.1/pelaporan/105905/empty,Juma Suki,Mardingding,2950000,3310000,13-11-2023,360000
948,1406,https://mpo.psp.pertanian.go.id/v.5.1/pelaporan/105906/empty,Kalimpon,Mardingding,2950000,3310000,13-11-2023,360000
949,1407,https://mpo.psp.pertanian.go.id/v.5.1/pelaporan/105907/empty,Juma Uruk,Mardingding,2950000,3310000,13-11-2023,360000
950,1408,https://mpo.psp.pertanian.go.id/v.5.1/pelaporan/105908/empty,Juma Pusong-pusong,Mardingding,2950000,3310000,13-11-2023,360000
951,1409,https://mpo.psp.pertanian.go.id/v.5.1/pelaporan/105909/empty,Juma Buah,Mardingding,2950000,3310000,13-11-2023,360000
952,1410,https://mpo.psp.pertanian.go.id/v.5.1/pelaporan/105911/empty,Moria IV,Beganding,2950000,3310000,09-11-2023,360000
953,1411,https://mpo.psp.pertanian.go.id/v.5.1/pelaporan/105912/empty,Juma Kenjahe,Beganding,3540000,3972000,09-11-2023,432000
954,1412,https://mpo.psp.pertanian.go.id/v.5.1/pelaporan/105913/empty,Lau Tuba,Beganding,2950000,3310000,09-11-2023,360000
955,1413,https://mpo.psp.pertanian.go.id/v.5.1/pelaporan/105914/empty,Juma Melas,Beganding,2950000,3310000,09-11-2023,360000
956,1414,https://mpo.psp.pertanian.go.id/v.5.1/pelaporan/105915/empty,Juma Louning,Beganding,2950000,3310000,09-11-2023,360000
957,1415,https://mpo.psp.pertanian.go.id/v.5.1/pelaporan/105916/empty,Juma Sepang,Beganding,3540000,3972000,09-11-2023,432000
958,1416,https://mpo.psp.pertanian.go.id/v.5.1/pelaporan/105917/empty,Juma Uruk Puntung,Beganding,3540000,3972000,09-11-2023,432000
959,1417,https://mpo.psp.pertanian.go.id/v.5.1/pelaporan/105919/empty,Juma Reba,Beganding,2950000,3310000,09-11-2023,360000
960,1418,https://mpo.psp.pertanian.go.id/v.5.1/pelaporan/105920/empty,Aisyah,Beganding,2950000,3310000,09-11-2023,360000
961,1419,https://mpo.psp.pertanian.go.id/v.5.1/pelaporan/105921/empty,Juma Sepandak,Beganding,3540000,3972000,09-11-2023,432000
962,1420,https://mpo.psp.pertanian.go.id/v.5.1/pelaporan/105922/empty,Juma Lau Buluh,Beganding,4425000,4965000,09-11-2023,540000
963,1421,https://mpo.psp.pertanian.go.id/v.5.1/pelaporan/105923/empty,Juma Simalem II,Beganding,2950000,3310000,09-11-2023,360000
964,1422,https://mpo.psp.pertanian.go.id/v.5.1/pelaporan/105924/empty,Biak Rawan,Beganding,2950000,3310000,09-11-2023,360000
965,1423,https://mpo.psp.pertanian.go.id/v.5.1/pelaporan/105925/empty,Juma Rumah Nangka,Beganding,3540000,3972000,09-11-2023,432000
966,1424,https://mpo.psp.pertanian.go.id/v.5.1/pelaporan/105926/empty,Uruk Perlamben,Beganding,4425000,4965000,09-11-2023,540000
967,1425,https://mpo.psp.pertanian.go.id/v.5.1/pelaporan/105928/empty,Juma Lepar,Beganding,2950000,3310000,09-11-2023,360000
968,1426,https://mpo.psp.pertanian.go.id/v.5.1/pelaporan/105929/empty,Arih Ersada,Beganding,2950000,3310000,09-11-2023,360000
969,1427,https://mpo.psp.pertanian.go.id/v.5.1/pelaporan/105930/empty,Juma Persoten,Nangbelawan,2950000,3310000,09-11-2023,360000
970,1428,https://mpo.psp.pertanian.go.id/v.5.1/pelaporan/105931/empty,Juma Jalang,Nangbelawan,2950000,3310000,09-11-2023,360000
971,1429,https://mpo.psp.pertanian.go.id/v.5.1/pelaporan/105932/empty,Juma Namo raya,Nangbelawan,2950000,3310000,09-11-2023,360000
972,1430,https://mpo.psp.pertanian.go.id/v.5.1/pelaporan/105934/empty,Juma simuk-muk,Nangbelawan,2950000,3310000,09-11-2023,360000
973,1431,https://mpo.psp.pertanian.go.id/v.5.1/pelaporan/105935/empty,Juma Buah Sinuan,Nangbelawan,2950000,3310000,09-11-2023,360000
974,1432,https://mpo.psp.pertanian.go.id/v.5.1/pelaporan/105936/empty,Juma Rakit,Nangbelawan,2950000,3310000,09-11-2023,360000
975,1433,https://mpo.psp.pertanian.go.id/v.5.1/pelaporan/105937/empty,Juma Lepar I,Nangbelawan,2950000,3310000,09-11-2023,360000
976,1434,https://mpo.psp.pertanian.go.id/v.5.1/pelaporan/113997/empty,Sementara,Nangbelawan,2950000,3310000,09-11-2023,360000
977,1435,https://mpo.psp.pertanian.go.id/v.5.1/pelaporan/113998/empty,Juma Lepar,Nangbelawan,2950000,3310000,09-11-2023,360000
978,1436,https://mpo.psp.pertanian.go.id/v.5.1/pelaporan/113999/empty,Juma Kesumpat,Nangbelawan,2950000,3310000,09-11-2023,360000
979,1437,https://mpo.psp.pertanian.go.id/v.5.1/pelaporan/114000/empty,Arih Ersada,Sirumbia,4425000,4965000,09-11-2023,540000
980,1438,https://mpo.psp.pertanian.go.id/v.5.1/pelaporan/114001/empty,Juma Tampe,Sirumbia,4130000,4634000,09-11-2023,504000
981,1439,https://mpo.psp.pertanian.go.id/v.5.1/pelaporan/114002/empty,Simulih Karaben,Sirumbia,4130000,4634000,09-11-2023,504000
982,1440,https://mpo.psp.pertanian.go.id/v.5.1/pelaporan/114003/empty,Juma Kenjulu I,Sirumbia,4425000,4965000,09-11-2023,540000
983,1441,https://mpo.psp.pertanian.go.id/v.5.1/pelaporan/114004/empty,Juma Kenjulu II,Sirumbia,3540000,3972000,09-11-2023,432000
984,1442,https://mpo.psp.pertanian.go.id/v.5.1/pelaporan/114005/empty,Juma Lau Gerat,Sirumbia,2950000,3310000,09-11-2023,360000
985,1443,https://mpo.psp.pertanian.go.id/v.5.1/pelaporan/114006/empty,Juma Serasi,Sirumbia,3540000,3972000,09-11-2023,432000
986,1444,https://mpo.psp.pertanian.go.id/v.5.1/pelaporan/114007/empty,Juma Sekula,Sirumbia,3540000,3972000,09-11-2023,432000
987,1445,https://mpo.psp.pertanian.go.id/v.5.1/pelaporan/114008/empty,Juma Lau Bengkuang,Sirumbia,4425000,4965000,09-11-2023,540000
988,1446,https://mpo.psp.pertanian.go.id/v.5.1/pelaporan/114009/empty,Juma Berneh,Lau Simomo,5900000,6620000,09-11-2023,720000
989,1447,https://mpo.psp.pertanian.go.id/v.5.1/pelaporan/114010/empty,Juma Kenjahe,Lau Simomo,5900000,6620000,09-11-2023,720000
990,1448,https://mpo.psp.pertanian.go.id/v.5.1/pelaporan/114011/empty,Juma Kampung Baru,Lau Simomo,5900000,6620000,09-11-2023,720000
991,1449,https://mpo.psp.pertanian.go.id/v.5.1/pelaporan/114012/empty,Juma Uruk,Lau Simomo,5900000,6620000,09-11-2023,720000
992,1450,https://mpo.psp.pertanian.go.id/v.5.1/pelaporan/114013/empty,Juma Sosial,Lau Simomo,5900000,6620000,09-11-2023,720000
993,1451,https://mpo.psp.pertanian.go.id/v.5.1/pelaporan/114014/empty,Juma Kesain Mbelang,Lau Simomo,5900000,6620000,09-11-2023,720000
994,1452,https://mpo.psp.pertanian.go.id/v.5.1/pelaporan/114015/empty,Sangap Encari,Kandibata,4425000,4965000,09-11-2023,540000
995,1453,https://mpo.psp.pertanian.go.id/v.5.1/pelaporan/114016/empty,Juma Tengah,Kandibata,4425000,4965000,09-11-2023,540000
996,1454,https://mpo.psp.pertanian.go.id/v.5.1/pelaporan/114017/empty,Juma Saringgetep,Kandibata,4425000,4965000,09-11-2023,540000
997,1455,https://mpo.psp.pertanian.go.id/v.5.1/pelaporan/114018/empty,Juma Binara,Kandibata,4425000,4965000,09-11-2023,540000
998,1456,https://mpo.psp.pertanian.go.id/v.5.1/pelaporan/114019/empty,Juma Begayo,Kandibata,4425000,4965000,09-11-2023,540000
999,1457,https://mpo.psp.pertanian.go.id/v.5.1/pelaporan/114020/empty,Juma Tambak,Kandibata,4425000,4965000,09-11-2023,540000
1000,1458,https://mpo.psp.pertanian.go.id/v.5.1/pelaporan/114021/empty,Juma Tungkup,Kandibata,2950000,3310000,09-11-2023,360000
1001,1459,https://mpo.psp.pertanian.go.id/v.5.1/pelaporan/114022/empty,Juma Tenembuk,Kandibata,2950000,3310000,09-11-2023,360000
1002,1460,https://mpo.psp.pertanian.go.id/v.5.1/pelaporan/114023/empty,Juma Eluk,Kandibata,2950000,3310000,09-11-2023,360000
1003,1461,https://mpo.psp.pertanian.go.id/v.5.1/pelaporan/114024/empty,Rumah Selat,Kandibata,4425000,4965000,09-11-2023,540000
1004,1462,https://mpo.psp.pertanian.go.id/v.5.1/pelaporan/114025/empty,Pola Munte,Kandibata,2950000,3310000,09-11-2023,360000
1005,1463,https://mpo.psp.pertanian.go.id/v.5.1/pelaporan/114026/empty,Sada Nioga,Kandibata,2950000,3310000,09-11-2023,360000
1006,1464,https://mpo.psp.pertanian.go.id/v.5.1/pelaporan/114027/empty,Lau Sianak,Kandibata,2950000,3310000,09-11-2023,360000
1007,1465,https://mpo.psp.pertanian.go.id/v.5.1/pelaporan/114028/empty,Rudang Tani,Kandibata,2950000,3310000,09-11-2023,360000
1008,1466,https://mpo.psp.pertanian.go.id/v.5.1/pelaporan/114029/empty,Buluh Duri,Kandibata,2950000,3310000,09-11-2023,360000
1009,1467,https://mpo.psp.pertanian.go.id/v.5.1/pelaporan/114030/empty,Kerangen Kutajulu,Kandibata,4425000,4965000,09-11-2023,540000
1010,1468,https://mpo.psp.pertanian.go.id/v.5.1/pelaporan/114031/empty,Rembang Tengah,Kandibata,4425000,4965000,09-11-2023,540000
1011,1469,https://mpo.psp.pertanian.go.id/v.5.1/pelaporan/114032/empty,Tangan baju,Samura,7375000,8275000,09-11-2023,900000
1012,1470,https://mpo.psp.pertanian.go.id/v.5.1/pelaporan/114033/empty,Juma Deleng,Kem Kem,2950000,3310000,08-11-2023,360000
1013,1471,https://mpo.psp.pertanian.go.id/v.5.1/pelaporan/114034/empty,Juma Kendit,Kem Kem,2950000,3310000,08-11-2023,360000
1014,1472,https://mpo.psp.pertanian.go.id/v.5.1/pelaporan/114035/empty,Kerangen Telu-telu,Kem Kem,2950000,3310000,08-11-2023,360000
1015,1473,https://mpo.psp.pertanian.go.id/v.5.1/pelaporan/114036/empty,Kemiri,Kem Kem,2950000,3310000,08-11-2023,360000
1016,1474,https://mpo.psp.pertanian.go.id/v.5.1/pelaporan/114037/empty,Tongkoh,Kem Kem,2950000,3310000,08-11-2023,360000
1017,1475,https://mpo.psp.pertanian.go.id/v.5.1/pelaporan/114038/empty,Buah Leweh,Perbesi,1770000,1986000,08-11-2023,216000
1018,1476,https://mpo.psp.pertanian.go.id/v.5.1/pelaporan/114039/empty,Dalan Kuda,Perbesi,1770000,1986000,08-11-2023,216000
1019,1477,https://mpo.psp.pertanian.go.id/v.5.1/pelaporan/114040/empty,Uruk Kenas,Perbesi,1770000,1986000,08-11-2023,216000
1020,1478,https://mpo.psp.pertanian.go.id/v.5.1/pelaporan/114041/empty,Uruk Jawi,Perbesi,1770000,1986000,08-11-2023,216000
1021,1479,https://mpo.psp.pertanian.go.id/v.5.1/pelaporan/114042/empty,Kuta Jahe,Perbesi,1770000,1986000,08-11-2023,216000
1022,1480,https://mpo.psp.pertanian.go.id/v.5.1/pelaporan/114043/empty,Tangger,Perbesi,1770000,1986000,08-11-2023,216000
1023,1481,https://mpo.psp.pertanian.go.id/v.5.1/pelaporan/114044/empty,Napa,Perbesi,1770000,1986000,08-11-2023,216000
1024,1482,https://mpo.psp.pertanian.go.id/v.5.1/pelaporan/114045/empty,Buloh Duri,Perbesi,1770000,1986000,08-11-2023,216000
1025,1483,https://mpo.psp.pertanian.go.id/v.5.1/pelaporan/114046/empty,Paya Sulangat,Perbesi,1770000,1986000,08-11-2023,216000
1026,1484,https://mpo.psp.pertanian.go.id/v.5.1/pelaporan/114047/empty,Mondul,Perbesi,1770000,1986000,08-11-2023,216000
1027,1485,https://mpo.psp.pertanian.go.id/v.5.1/pelaporan/114048/empty,Mbuah Page,Kuta Bangun,7375000,8275000,08-11-2023,900000
1028,1486,https://mpo.psp.pertanian.go.id/v.5.1/pelaporan/114049/empty,Pancur Timah,Simolap,7375000,8275000,08-11-2023,900000
1029,1487,https://mpo.psp.pertanian.go.id/v.5.1/pelaporan/114050/empty,Paya Mbelang,Kuta Buara,7670000,8606000,08-11-2023,936000
1030,1488,https://mpo.psp.pertanian.go.id/v.5.1/pelaporan/114051/empty,Paya Tereb,Suka Julu,14750000,16550000,08-11-2023,1800000
1031,1489,https://mpo.psp.pertanian.go.id/v.5.1/pelaporan/114052/empty,Kuta Mbaru Punti I,Kutambaru Punti,8850000,9930000,08-11-2023,1080000
1032,1490,https://mpo.psp.pertanian.go.id/v.5.1/pelaporan/114053/empty,Lau Tambak,Batumamak,11800000,13240000,08-11-2023,1440000
1033,1491,https://mpo.psp.pertanian.go.id/v.5.1/pelaporan/114054/empty,Lau Kami,Limang,7375000,8275000,08-11-2023,900000
1034,1492,https://mpo.psp.pertanian.go.id/v.5.1/pelaporan/114055/empty,Kerenda,Limang,7375000,8275000,08-11-2023,900000
1035,1493,https://mpo.psp.pertanian.go.id/v.5.1/pelaporan/114056/empty,Kuta Jahe,Limang,7375000,8275000,08-11-2023,900000
1036,1494,https://mpo.psp.pertanian.go.id/v.5.1/pelaporan/114057/empty,Kuta Gerat Simalem,Kuta Gerat,5900000,6620000,08-11-2023,720000
1037,1495,https://mpo.psp.pertanian.go.id/v.5.1/pelaporan/114058/empty,Lau Tepian Simalem,Kuta Gerat,5900000,6620000,08-11-2023,720000
1038,1496,https://mpo.psp.pertanian.go.id/v.5.1/pelaporan/114059/empty,Paya Jering,Kuta Gerat,5900000,6620000,08-11-2023,720000
1039,1497,https://mpo.psp.pertanian.go.id/v.5.1/pelaporan/114060/empty,Tongkeh Mbiring,Kuta Gerat,5900000,6620000,08-11-2023,720000
1040,1498,https://mpo.psp.pertanian.go.id/v.5.1/pelaporan/114061/empty,Uruk Pacinta,Kuta Gerat,5900000,6620000,08-11-2023,720000
1041,1499,https://mpo.psp.pertanian.go.id/v.5.1/pelaporan/114062/empty,Paya Ingul,Bunga Baru,17700000,19860000,08-11-2023,2160000
1042,1500,https://mpo.psp.pertanian.go.id/v.5.1/pelaporan/114063/empty,Juma Buluh,Kuala,15045000,16881000,08-11-2023,1836000
1043,1501,https://mpo.psp.pertanian.go.id/v.5.1/pelaporan/114064/empty,Batu Gale,Gunung,16225000,18205000,08-11-2023,1980000
